Recency,Frequency,Monetary,R_Quartile,F_Quartile,M_Quartile,RFM_Sum,Segment
31,6,3089.91,3,4,4,11,Champions
240,3,90.2,1,3,1,5,At Risk
10,1,999.15,4,1,3,8,Potential Loyalist
302,1,294.4,1,1,2,4,Lost
28,7,1130.94,3,4,4,11,Champions
195,1,29.300000000000004,1,1,1,3,Lost
224,1,682.69,1,1,3,5,At Risk
206,1,219.0,1,1,2,4,Lost
237,2,1086.56,1,2,3,6,At Risk
25,1,3315.41,3,1,4,8,Potential Loyalist
142,1,369.06,2,1,2,5,At Risk
49,4,3224.13,3,3,4,10,Loyal Customers
44,3,1843.16,3,3,4,10,Loyal Customers
279,1,174.9,1,1,1,3,Lost
27,9,3655.7,3,4,4,11,Champions
101,2,484.5,2,2,3,7,Potential Loyalist
32,2,810.96,3,2,3,8,Potential Loyalist
283,1,307.94,1,1,2,4,Lost
43,4,2602.41,3,3,4,10,Loyal Customers
51,1,1300.46,2,1,4,7,Potential Loyalist
63,3,938.34,2,3,3,8,Potential Loyalist
303,1,299.1,1,1,2,4,Lost
17,1,531.73,4,1,3,8,Potential Loyalist
2,2,283.3,4,2,2,8,Potential Loyalist
307,2,1472.52,1,2,4,7,Potential Loyalist
121,1,3396.64,2,1,4,7,Potential Loyalist
73,2,736.44,2,2,3,7,Potential Loyalist
13,4,1738.25,4,3,4,11,Champions
25,4,1159.2,3,3,4,10,Loyal Customers
176,5,1211.84,1,4,4,9,Loyal Customers
20,2,286.32,3,2,2,7,Potential Loyalist
358,1,215.7,1,1,2,4,Lost
7,6,2466.7000000000003,4,4,4,12,Champions
71,1,407.74,2,1,2,5,At Risk
13,1,428.11,4,1,2,7,Potential Loyalist
64,4,1193.5,2,3,4,9,Loyal Customers
209,1,331.18,1,1,2,4,Lost
11,12,1844.57,4,4,4,12,Champions
27,2,1720.01,3,2,4,9,Loyal Customers
37,1,1349.44,3,1,4,8,Potential Loyalist
111,4,729.15,2,3,3,8,Potential Loyalist
295,1,32.85,1,1,1,3,Lost
315,1,195.6,1,1,1,3,Lost
41,1,92.9,3,1,1,5,At Risk
140,1,1104.8700000000001,2,1,3,6,At Risk
13,2,2871.78,4,2,4,10,Loyal Customers
41,5,1085.01,3,4,3,10,Loyal Customers
24,5,1869.47,3,4,4,11,Champions
70,3,1646.79,2,3,4,9,Loyal Customers
300,1,274.23,1,1,2,4,Lost
66,3,1115.04,2,3,4,9,Loyal Customers
58,3,545.2,2,3,3,8,Potential Loyalist
209,3,343.65,1,3,2,6,At Risk
16,11,3756.06,4,4,4,12,Champions
31,8,1931.8700000000001,3,4,4,11,Champions
104,1,418.16,2,1,2,5,At Risk
55,1,380.3,2,1,2,5,At Risk
7,4,607.57,4,3,3,10,Loyal Customers
87,3,645.3100000000001,2,3,3,8,Potential Loyalist
92,7,1341.97,2,4,4,10,Loyal Customers
154,2,703.72,1,2,3,6,At Risk
70,1,538.14,2,1,3,6,At Risk
186,1,446.08,1,1,2,4,Lost
13,3,425.62,4,3,2,9,Loyal Customers
17,8,4830.43,4,4,4,12,Champions
1,4,2313.04,4,3,4,11,Champions
35,1,168.6,3,1,1,5,At Risk
27,14,3933.55,3,4,4,11,Champions
34,4,1909.68,3,3,4,10,Loyal Customers
1,5,6853.86,4,4,4,12,Champions
76,2,624.84,2,2,3,7,Potential Loyalist
259,1,78.0,1,1,1,3,Lost
91,1,429.01000000000005,2,1,2,5,At Risk
1,17,2725.14,4,4,4,12,Champions
6,2,1753.1200000000001,4,2,4,10,Loyal Customers
358,1,155.55,1,1,1,3,Lost
13,5,2382.56,4,4,4,12,Champions
13,1,77.4,4,1,1,6,At Risk
49,1,734.36,3,1,3,7,Potential Loyalist
235,1,379.78999999999996,1,1,2,4,Lost
36,1,283.95,3,1,2,6,At Risk
14,4,2733.84,4,3,4,11,Champions
148,2,131.88,1,2,1,4,Lost
2,5,5878.31,4,4,4,12,Champions
8,1,287.67,4,1,2,7,Potential Loyalist
126,1,707.09,2,1,3,6,At Risk
48,1,66.4,3,1,1,5,At Risk
65,5,1201.8600000000001,2,4,4,10,Loyal Customers
36,3,1663.24,3,3,4,10,Loyal Customers
78,2,958.93,2,2,3,7,Potential Loyalist
63,2,612.38,2,2,3,7,Potential Loyalist
146,1,419.08,1,1,2,4,Lost
10,2,657.8,4,2,3,9,Loyal Customers
45,4,1155.38,3,3,4,10,Loyal Customers
141,4,76.5,2,3,1,6,At Risk
9,2,621.49,4,2,3,9,Loyal Customers
179,2,575.99,1,2,3,6,At Risk
2,25,7887.95,4,4,4,12,Champions
24,7,5052.03,3,4,4,11,Champions
45,3,2229.45,3,3,4,10,Loyal Customers
9,18,6166.9,4,4,4,12,Champions
45,1,561.9399999999999,3,1,3,7,Potential Loyalist
7,10,3530.83,4,4,4,12,Champions
14,6,7057.34,4,4,4,12,Champions
3,1,426.35,4,1,2,7,Potential Loyalist
20,4,2266.94,3,3,4,10,Loyal Customers
14,10,3462.2,4,4,4,12,Champions
9,7,1486.54,4,4,4,12,Champions
27,4,3336.98,3,3,4,10,Loyal Customers
1,3,952.1600000000001,4,3,3,10,Loyal Customers
328,1,191.43,1,1,1,3,Lost
9,9,3818.81,4,4,4,12,Champions
30,1,350.75,3,1,2,6,At Risk
55,2,227.21,2,2,2,6,At Risk
157,2,332.91,1,2,2,5,At Risk
7,7,951.75,4,4,3,11,Champions
73,1,20.4,2,1,1,4,Lost
13,3,349.70000000000005,4,3,2,9,Loyal Customers
41,7,497.89,3,4,3,10,Loyal Customers
328,1,1866.66,1,1,4,6,At Risk
87,5,1511.32,2,4,4,10,Loyal Customers
22,1,60.0,3,1,1,5,At Risk
224,1,57.6,1,1,1,3,Lost
126,3,388.75,2,3,2,7,Potential Loyalist
18,2,398.27,3,2,2,7,Potential Loyalist
276,1,124.5,1,1,1,3,Lost
134,2,620.05,2,2,3,7,Potential Loyalist
58,2,130.07999999999998,2,2,1,5,At Risk
104,1,520.04,2,1,3,6,At Risk
259,1,779.68,1,1,3,5,At Risk
345,1,190.8,1,1,1,3,Lost
69,2,270.48,2,2,2,6,At Risk
20,4,2198.09,3,3,4,10,Loyal Customers
20,4,1446.95,3,3,4,10,Loyal Customers
55,1,252.84,2,1,2,5,At Risk
71,5,2061.56,2,4,4,10,Loyal Customers
134,1,499.03,2,1,3,6,At Risk
31,2,152.72,3,2,1,6,At Risk
11,11,1277.91,4,4,4,12,Champions
1,8,1719.21,4,4,4,12,Champions
45,2,899.78,3,2,3,8,Potential Loyalist
73,3,296.71000000000004,2,3,2,7,Potential Loyalist
1,6,1121.63,4,4,4,12,Champions
51,4,1051.42,2,3,3,8,Potential Loyalist
6,1,95.27,4,1,1,6,At Risk
22,1,297.33000000000004,3,1,2,6,At Risk
122,1,828.73,2,1,3,6,At Risk
83,2,577.85,2,2,3,7,Potential Loyalist
51,1,3659.97,2,1,4,7,Potential Loyalist
21,1,258.75,3,1,2,6,At Risk
14,4,4141.6,4,3,4,11,Champions
11,17,7967.64,4,4,4,12,Champions
21,3,721.38,3,3,3,9,Loyal Customers
28,1,284.9,3,1,2,6,At Risk
67,2,698.8,2,2,3,7,Potential Loyalist
38,2,969.58,3,2,3,8,Potential Loyalist
189,2,151.79999999999998,1,2,1,4,Lost
158,1,67.19999999999999,1,1,1,3,Lost
71,1,748.88,2,1,3,6,At Risk
349,1,168.0,1,1,1,3,Lost
31,1,165.47,3,1,1,5,At Risk
17,9,2760.6,4,4,4,12,Champions
42,2,517.81,3,2,3,8,Potential Loyalist
311,1,301.41,1,1,2,4,Lost
135,1,1153.46,2,1,4,7,Potential Loyalist
294,1,207.05,1,1,2,4,Lost
14,6,2358.21,4,4,4,12,Champions
253,1,336.15,1,1,2,4,Lost
280,1,145.92,1,1,1,3,Lost
78,1,222.13,2,1,2,5,At Risk
14,10,6673.58,4,4,4,12,Champions
8,23,2330.57,4,4,4,12,Champions
31,2,489.37,3,2,3,8,Potential Loyalist
43,1,340.29,3,1,2,6,At Risk
219,1,150.59,1,1,1,3,Lost
307,1,162.55,1,1,1,3,Lost
27,5,1225.31,3,4,4,11,Champions
27,3,570.65,3,3,3,9,Loyal Customers
13,2,2242.96,4,2,4,10,Loyal Customers
70,1,329.12,2,1,2,5,At Risk
238,1,379.7,1,1,2,4,Lost
31,1,169.76,3,1,1,5,At Risk
230,2,313.92,1,2,2,5,At Risk
10,14,4765.36,4,4,4,12,Champions
9,7,967.5500000000001,4,4,3,11,Champions
226,2,1212.95,1,2,4,7,Potential Loyalist
9,1,186.54000000000002,4,1,1,6,At Risk
31,1,79.65,3,1,1,5,At Risk
20,2,417.28,3,2,2,7,Potential Loyalist
203,1,877.26,1,1,3,5,At Risk
309,1,323.1,1,1,2,4,Lost
84,2,350.6,2,2,2,6,At Risk
100,3,382.09999999999997,2,3,2,7,Potential Loyalist
38,8,2743.43,3,4,4,11,Champions
43,2,288.27,3,2,2,7,Potential Loyalist
11,4,2544.07,4,3,4,11,Champions
1,7,2103.43,4,4,4,12,Champions
21,7,764.38,3,4,3,10,Loyal Customers
20,9,1996.22,3,4,4,11,Champions
181,5,371.51,1,4,2,7,Potential Loyalist
50,1,129.22,2,1,1,4,Lost
13,1,1.0,4,1,1,6,At Risk
71,2,236.18,2,2,2,6,At Risk
52,1,1490.26,2,1,4,7,Potential Loyalist
70,3,846.11,2,3,3,8,Potential Loyalist
14,4,1479.6399999999999,4,3,4,11,Champions
44,1,924.52,3,1,3,7,Potential Loyalist
66,1,654.0,2,1,3,6,At Risk
49,4,2886.4,3,3,4,10,Loyal Customers
269,1,218.15,1,1,2,4,Lost
28,3,1253.26,3,3,4,10,Loyal Customers
87,2,386.79999999999995,2,2,2,6,At Risk
21,1,335.63,3,1,2,6,At Risk
13,1,121.41,4,1,1,6,At Risk
8,8,681.02,4,4,3,11,Champions
6,3,1100.1399999999999,4,3,3,10,Loyal Customers
15,18,6842.74,4,4,4,12,Champions
224,1,123.85,1,1,1,3,Lost
268,1,269.1,1,1,2,4,Lost
98,2,492.78,2,2,3,7,Potential Loyalist
203,2,1625.82,1,2,4,7,Potential Loyalist
15,9,4945.49,4,4,4,12,Champions
2,6,3675.3,4,4,4,12,Champions
25,2,468.21,3,2,3,8,Potential Loyalist
1,2,905.08,4,2,3,9,Loyal Customers
49,1,396.0,3,1,2,6,At Risk
50,4,1379.94,2,3,4,9,Loyal Customers
81,2,1357.69,2,2,4,8,Potential Loyalist
59,8,5075.84,2,4,4,10,Loyal Customers
25,1,498.25,3,1,3,7,Potential Loyalist
230,1,325.3,1,1,2,4,Lost
15,3,609.53,4,3,3,10,Loyal Customers
107,1,128.9,2,1,1,4,Lost
17,3,743.77,4,3,3,10,Loyal Customers
212,2,73.28,1,2,1,4,Lost
121,1,417.12,2,1,2,5,At Risk
25,4,1406.18,3,3,4,10,Loyal Customers
41,1,316.48,3,1,2,6,At Risk
14,12,1843.87,4,4,4,12,Champions
146,1,255.3,1,1,2,4,Lost
99,3,513.0500000000001,2,3,3,8,Potential Loyalist
326,1,114.0,1,1,1,3,Lost
323,1,732.28,1,1,3,5,At Risk
140,2,752.81,2,2,3,7,Potential Loyalist
2,5,499.33,4,4,3,11,Champions
9,5,1873.35,4,4,4,12,Champions
3,3,623.0,4,3,3,10,Loyal Customers
10,1,535.4,4,1,3,8,Potential Loyalist
21,1,45.6,3,1,1,5,At Risk
3,1,203.7,4,1,1,6,At Risk
15,10,3098.38,4,4,4,12,Champions
50,4,406.8,2,3,2,7,Potential Loyalist
316,1,45.0,1,1,1,3,Lost
50,1,410.23,2,1,2,5,At Risk
3,4,2666.0,4,3,4,11,Champions
142,2,1319.92,2,2,4,8,Potential Loyalist
2,5,2087.47,4,4,4,12,Champions
321,1,162.29999999999998,1,1,1,3,Lost
318,1,182.8,1,1,1,3,Lost
30,4,1289.54,3,3,4,10,Loyal Customers
16,6,1031.39,4,4,3,11,Champions
34,8,1359.8,3,4,4,11,Champions
275,1,639.86,1,1,3,5,At Risk
65,3,487.52,2,3,3,8,Potential Loyalist
6,21,9584.4,4,4,4,12,Champions
1,29,7928.86,4,4,4,12,Champions
42,13,4641.93,3,4,4,11,Champions
16,5,1484.79,4,4,4,12,Champions
20,6,2437.65,3,4,4,11,Champions
363,1,71.14,1,1,1,3,Lost
105,1,2770.04,2,1,4,7,Potential Loyalist
17,2,1020.21,4,2,3,9,Loyal Customers
197,1,265.11,1,1,2,4,Lost
50,4,678.2,2,3,3,8,Potential Loyalist
118,4,476.51,2,3,3,8,Potential Loyalist
62,2,447.62,2,2,2,6,At Risk
58,3,306.96000000000004,2,3,2,7,Potential Loyalist
20,3,676.71,3,3,3,9,Loyal Customers
57,3,2882.71,2,3,4,9,Loyal Customers
71,2,652.45,2,2,3,7,Potential Loyalist
11,1,201.0,4,1,1,6,At Risk
62,1,265.55,2,1,2,5,At Risk
14,7,1124.04,4,4,4,12,Champions
7,8,5154.4,4,4,4,12,Champions
283,1,417.52000000000004,1,1,2,4,Lost
21,10,2117.96,3,4,4,11,Champions
7,14,4615.32,4,4,4,12,Champions
88,3,909.8199999999999,2,3,3,8,Potential Loyalist
20,13,2586.98,3,4,4,11,Champions
1,5,3621.0299999999997,4,4,4,12,Champions
98,1,273.86,2,1,2,5,At Risk
125,1,597.16,2,1,3,6,At Risk
143,2,774.03,2,2,3,7,Potential Loyalist
63,1,182.35,2,1,1,4,Lost
57,1,230.60000000000002,2,1,2,5,At Risk
7,24,4182.92,4,4,4,12,Champions
23,6,2108.19,3,4,4,11,Champions
106,2,726.1,2,2,3,7,Potential Loyalist
8,3,521.05,4,3,3,10,Loyal Customers
73,3,733.1700000000001,2,3,3,8,Potential Loyalist
363,1,371.8,1,1,2,4,Lost
20,7,1550.1,3,4,4,11,Champions
2,7,2461.52,4,4,4,12,Champions
63,4,565.33,2,3,3,8,Potential Loyalist
105,1,360.71000000000004,2,1,2,5,At Risk
15,10,7116.69,4,4,4,12,Champions
171,1,178.26000000000002,1,1,1,3,Lost
226,1,276.85,1,1,2,4,Lost
344,1,110.39999999999999,1,1,1,3,Lost
307,2,375.07,1,2,2,5,At Risk
324,1,93.6,1,1,1,3,Lost
363,1,110.4,1,1,1,3,Lost
90,1,516.0,2,1,3,6,At Risk
55,1,344.8,2,1,2,5,At Risk
126,2,425.23,2,2,2,6,At Risk
48,4,4774.93,3,3,4,10,Loyal Customers
14,10,2444.91,4,4,4,12,Champions
1,188,20193.21,4,4,4,12,Champions
14,4,2197.37,4,3,4,11,Champions
120,1,184.98,2,1,1,4,Lost
73,1,854.12,2,1,3,6,At Risk
14,6,1988.77,4,4,4,12,Champions
269,2,61.62,1,2,1,4,Lost
272,1,7.6,1,1,1,3,Lost
78,1,50.879999999999995,2,1,1,4,Lost
7,7,3194.0,4,4,4,12,Champions
108,2,1468.59,2,2,4,8,Potential Loyalist
44,3,1279.09,3,3,4,10,Loyal Customers
17,1,389.09,4,1,2,7,Potential Loyalist
361,1,320.08,1,1,2,4,Lost
308,1,952.88,1,1,3,5,At Risk
49,6,5218.59,3,4,4,11,Champions
230,1,869.4,1,1,3,5,At Risk
51,1,615.3199999999999,2,1,3,6,At Risk
9,5,952.14,4,4,3,11,Champions
11,6,492.49,4,4,3,11,Champions
29,8,2523.53,3,4,4,11,Champions
55,2,594.54,2,2,3,7,Potential Loyalist
141,4,1603.1200000000001,2,3,4,9,Loyal Customers
24,3,805.22,3,3,3,9,Loyal Customers
7,1,497.07,4,1,3,8,Potential Loyalist
356,1,239.0,1,1,2,4,Lost
1,3,356.26,4,3,2,9,Loyal Customers
184,1,199.42000000000002,1,1,1,3,Lost
248,1,329.59,1,1,2,4,Lost
326,2,395.48,1,2,2,5,At Risk
45,2,795.51,3,2,3,8,Potential Loyalist
10,1,144.63,4,1,1,6,At Risk
357,1,206.13,1,1,2,4,Lost
178,1,397.58,1,1,2,4,Lost
28,3,445.7,3,3,2,8,Potential Loyalist
169,1,343.41,1,1,2,4,Lost
253,2,416.55,1,2,2,5,At Risk
36,1,229.64000000000001,3,1,2,6,At Risk
139,2,687.66,2,2,3,7,Potential Loyalist
87,2,265.90000000000003,2,2,2,6,At Risk
273,1,126.03999999999999,1,1,1,3,Lost
253,1,267.6,1,1,2,4,Lost
36,3,713.27,3,3,3,9,Loyal Customers
206,1,75.72,1,1,1,3,Lost
62,2,743.28,2,2,3,7,Potential Loyalist
51,1,316.42,2,1,2,5,At Risk
21,6,1318.2,3,4,4,11,Champions
24,2,318.7,3,2,2,7,Potential Loyalist
57,4,621.51,2,3,3,8,Potential Loyalist
328,1,28.5,1,1,1,3,Lost
254,1,124.75,1,1,1,3,Lost
24,2,366.53,3,2,2,7,Potential Loyalist
137,1,307.03000000000003,2,1,2,5,At Risk
274,1,201.08,1,1,1,3,Lost
51,4,1622.6200000000001,2,3,4,9,Loyal Customers
165,1,58.75,1,1,1,3,Lost
25,2,586.48,3,2,3,8,Potential Loyalist
3,13,4453.53,4,4,4,12,Champions
135,4,2726.77,2,3,4,9,Loyal Customers
6,23,3228.08,4,4,4,12,Champions
62,2,582.3100000000001,2,2,3,7,Potential Loyalist
151,7,1395.69,1,4,4,9,Loyal Customers
21,2,325.96000000000004,3,2,2,7,Potential Loyalist
260,2,54.79,1,2,1,4,Lost
14,1,668.14,4,1,3,8,Potential Loyalist
23,2,777.74,3,2,3,8,Potential Loyalist
88,1,108.28,2,1,1,4,Lost
286,1,264.15000000000003,1,1,2,4,Lost
126,5,1227.2,2,4,4,10,Loyal Customers
70,3,1056.4,2,3,3,8,Potential Loyalist
364,1,38.1,1,1,1,3,Lost
10,5,1764.58,4,4,4,12,Champions
202,2,831.15,1,2,3,6,At Risk
44,1,109.2,3,1,1,5,At Risk
130,1,10.2,2,1,1,4,Lost
18,2,1355.82,3,2,4,9,Loyal Customers
275,1,344.92,1,1,2,4,Lost
18,7,3664.77,3,4,4,11,Champions
177,6,1534.71,1,4,4,9,Loyal Customers
76,2,120.53999999999999,2,2,1,5,At Risk
318,2,507.12,1,2,3,6,At Risk
49,2,1100.82,3,2,3,8,Potential Loyalist
16,11,1370.81,4,4,4,12,Champions
228,2,839.09,1,2,3,6,At Risk
36,3,220.66,3,3,2,8,Potential Loyalist
267,1,69.0,1,1,1,3,Lost
1,2,995.4,4,2,3,9,Loyal Customers
16,4,527.87,4,3,3,10,Loyal Customers
80,1,107.25,2,1,1,4,Lost
55,3,977.22,2,3,3,8,Potential Loyalist
59,2,1059.3600000000001,2,2,3,7,Potential Loyalist
206,2,187.92000000000002,1,2,1,4,Lost
16,1,365.38,4,1,2,7,Potential Loyalist
22,1,188.14,3,1,1,5,At Risk
34,2,335.05,3,2,2,7,Potential Loyalist
196,2,100.50000000000001,1,2,1,4,Lost
2,15,1162.35,4,4,4,12,Champions
256,1,87.78,1,1,1,3,Lost
10,2,351.73,4,2,2,8,Potential Loyalist
3,5,1108.02,4,4,4,12,Champions
31,5,1022.43,3,4,3,10,Loyal Customers
15,8,2297.02,4,4,4,12,Champions
6,3,426.3,4,3,2,9,Loyal Customers
7,4,939.57,4,3,3,10,Loyal Customers
140,2,201.05,2,2,1,5,At Risk
130,4,1821.5,2,3,4,9,Loyal Customers
8,5,888.31,4,4,3,11,Champions
9,1,108.34,4,1,1,6,At Risk
1,37,13030.37,4,4,4,12,Champions
153,1,377.3,1,1,2,4,Lost
56,1,157.07,2,1,1,4,Lost
80,4,644.2,2,3,3,8,Potential Loyalist
66,1,339.31,2,1,2,5,At Risk
27,5,1739.74,3,4,4,11,Champions
303,1,70.95,1,1,1,3,Lost
70,2,389.61,2,2,2,6,At Risk
59,2,48.160000000000004,2,2,1,5,At Risk
16,3,465.47,4,3,3,10,Loyal Customers
18,5,1580.19,3,4,4,11,Champions
9,3,911.9,4,3,3,10,Loyal Customers
7,4,1233.1200000000001,4,3,4,11,Champions
17,1,100.22,4,1,1,6,At Risk
326,1,81.36,1,1,1,3,Lost
46,2,529.47,3,2,3,8,Potential Loyalist
123,3,505.0,2,3,3,8,Potential Loyalist
27,2,519.81,3,2,3,8,Potential Loyalist
280,1,264.25,1,1,2,4,Lost
135,5,1269.59,2,4,4,10,Loyal Customers
8,7,1892.3600000000001,4,4,4,12,Champions
22,8,3639.92,3,4,4,11,Champions
16,1,186.8,4,1,1,6,At Risk
165,5,683.78,1,4,3,8,Potential Loyalist
35,3,828.4300000000001,3,3,3,9,Loyal Customers
1,1,192.45000000000002,4,1,1,6,At Risk
8,9,2892.6,4,4,4,12,Champions
298,1,74.67,1,1,1,3,Lost
1,8,3547.04,4,4,4,12,Champions
105,1,145.04000000000002,2,1,1,4,Lost
2,7,1399.41,4,4,4,12,Champions
81,1,597.71,2,1,3,6,At Risk
1,1,147.68,4,1,1,6,At Risk
349,2,452.2,1,2,2,5,At Risk
104,1,126.0,2,1,1,4,Lost
314,2,23.8,1,2,1,4,Lost
2,76,5213.030000000001,4,4,4,12,Champions
189,1,77.15,1,1,1,3,Lost
203,1,303.6,1,1,2,4,Lost
148,1,10.74,1,1,1,3,Lost
21,2,372.21999999999997,3,2,2,7,Potential Loyalist
234,1,376.5,1,1,2,4,Lost
10,1,97.5,4,1,1,6,At Risk
20,1,637.92,3,1,3,7,Potential Loyalist
65,2,392.45,2,2,2,6,At Risk
284,1,330.67,1,1,2,4,Lost
13,8,1148.1,4,4,4,12,Champions
23,3,351.0,3,3,2,8,Potential Loyalist
15,2,461.26,4,2,3,9,Loyal Customers
15,4,414.76,4,3,2,9,Loyal Customers
112,2,522.62,2,2,3,7,Potential Loyalist
14,4,880.09,4,3,3,10,Loyal Customers
197,2,273.78,1,2,2,5,At Risk
251,2,382.16,1,2,2,5,At Risk
14,12,4818.99,4,4,4,12,Champions
310,1,110.99999999999999,1,1,1,3,Lost
143,2,89.05000000000001,2,2,1,5,At Risk
3,17,5139.96,4,4,4,12,Champions
165,2,323.3,1,2,2,5,At Risk
48,1,11.52,3,1,1,5,At Risk
315,1,229.46999999999997,1,1,2,4,Lost
364,1,50.550000000000004,1,1,1,3,Lost
1,7,1431.15,4,4,4,12,Champions
13,12,3953.3,4,4,4,12,Champions
2,10,1499.03,4,4,4,12,Champions
45,5,2648.93,3,4,4,11,Champions
65,3,709.34,2,3,3,8,Potential Loyalist
8,28,6530.12,4,4,4,12,Champions
17,8,1662.13,4,4,4,12,Champions
56,2,439.86,2,2,2,6,At Risk
23,3,262.44,3,3,2,8,Potential Loyalist
14,2,613.4399999999999,4,2,3,9,Loyal Customers
22,2,116.5,3,2,1,6,At Risk
3,2,561.88,4,2,3,9,Loyal Customers
44,2,735.93,3,2,3,8,Potential Loyalist
349,1,190.55,1,1,1,3,Lost
46,2,627.82,3,2,3,8,Potential Loyalist
65,2,349.20000000000005,2,2,2,6,At Risk
130,3,693.37,2,3,3,8,Potential Loyalist
72,3,891.46,2,3,3,8,Potential Loyalist
25,1,303.25,3,1,2,6,At Risk
265,1,139.7,1,1,1,3,Lost
283,1,391.72,1,1,2,4,Lost
91,1,305.28000000000003,2,1,2,5,At Risk
22,2,419.11,3,2,2,7,Potential Loyalist
23,10,2646.26,3,4,4,11,Champions
6,4,1810.41,4,3,4,11,Champions
56,2,433.68,2,2,2,6,At Risk
6,17,4707.73,4,4,4,12,Champions
204,1,197.65,1,1,1,3,Lost
70,3,1104.06,2,3,3,8,Potential Loyalist
16,3,261.45000000000005,4,3,2,9,Loyal Customers
241,1,85.65,1,1,1,3,Lost
245,1,243.93,1,1,2,4,Lost
64,1,200.31,2,1,1,4,Lost
183,1,65.69999999999999,1,1,1,3,Lost
4,4,893.12,4,3,3,10,Loyal Customers
365,1,138.41,1,1,1,3,Lost
16,2,372.75,4,2,2,8,Potential Loyalist
74,1,91.61,2,1,1,4,Lost
6,23,3197.54,4,4,4,12,Champions
184,1,228.8,1,1,2,4,Lost
258,1,177.15,1,1,1,3,Lost
121,1,477.21,2,1,3,6,At Risk
282,3,516.09,1,3,3,7,Potential Loyalist
2,25,7271.150000000001,4,4,4,12,Champions
13,4,190.10000000000002,4,3,1,8,Potential Loyalist
171,1,58.08,1,1,1,3,Lost
3,11,17925.53,4,4,4,12,Champions
118,8,1177.36,2,4,4,10,Loyal Customers
67,1,158.44,2,1,1,4,Lost
149,2,217.68,1,2,2,5,At Risk
3,77,33998.89,4,4,4,12,Champions
11,12,3501.13,4,4,4,12,Champions
20,1,281.08,3,1,2,6,At Risk
62,5,266.61,2,4,2,8,Potential Loyalist
267,8,3429.4700000000003,1,4,4,9,Loyal Customers
197,2,106.2,1,2,1,4,Lost
62,1,60.48,2,1,1,4,Lost
24,10,4091.88,3,4,4,11,Champions
1,24,9277.58,4,4,4,12,Champions
226,1,65.5,1,1,1,3,Lost
15,22,4576.0599999999995,4,4,4,12,Champions
31,1,141.94,3,1,1,5,At Risk
38,3,393.71999999999997,3,3,2,8,Potential Loyalist
125,1,76.5,2,1,1,4,Lost
36,4,1092.0,3,3,3,9,Loyal Customers
364,1,95.3,1,1,1,3,Lost
51,2,763.2,2,2,3,7,Potential Loyalist
23,7,971.22,3,4,3,10,Loyal Customers
6,23,3161.74,4,4,4,12,Champions
3,4,2029.06,4,3,4,11,Champions
130,1,291.29,2,1,2,5,At Risk
13,8,840.7,4,4,3,11,Champions
11,5,1125.96,4,4,4,12,Champions
230,1,30.599999999999998,1,1,1,3,Lost
261,1,260.36,1,1,2,4,Lost
232,1,821.1,1,1,3,5,At Risk
81,3,2904.58,2,3,4,9,Loyal Customers
36,7,1467.23,3,4,4,11,Champions
69,1,259.17,2,1,2,5,At Risk
86,1,64.0,2,1,1,4,Lost
15,3,604.3,4,3,3,10,Loyal Customers
253,1,60.3,1,1,1,3,Lost
265,2,79.95,1,2,1,4,Lost
77,4,1392.14,2,3,4,9,Loyal Customers
48,5,2408.51,3,4,4,11,Champions
2,8,3553.89,4,4,4,12,Champions
14,6,946.49,4,4,3,11,Champions
8,7,2473.04,4,4,4,12,Champions
100,3,349.92,2,3,2,7,Potential Loyalist
76,5,2260.53,2,4,4,10,Loyal Customers
11,1,215.92,4,1,2,7,Potential Loyalist
324,1,47.2,1,1,1,3,Lost
31,3,297.6,3,3,2,8,Potential Loyalist
18,1,228.91,3,1,2,6,At Risk
35,2,237.60000000000002,3,2,2,7,Potential Loyalist
21,11,2709.2200000000003,3,4,4,11,Champions
6,4,1210.68,4,3,4,11,Champions
287,1,773.27,1,1,3,5,At Risk
25,4,843.0600000000001,3,3,3,9,Loyal Customers
41,4,1447.98,3,3,4,10,Loyal Customers
86,4,1193.5,2,3,4,9,Loyal Customers
42,3,933.23,3,3,3,9,Loyal Customers
14,1,75.89999999999999,4,1,1,6,At Risk
305,1,95.75,1,1,1,3,Lost
114,4,1156.15,2,3,4,9,Loyal Customers
38,2,349.28,3,2,2,7,Potential Loyalist
275,1,349.6,1,1,2,4,Lost
10,4,482.15999999999997,4,3,3,10,Loyal Customers
28,4,1108.39,3,3,4,10,Loyal Customers
55,2,355.1,2,2,2,6,At Risk
18,1,109.17,3,1,1,5,At Risk
13,3,261.51,4,3,2,9,Loyal Customers
359,1,165.94,1,1,1,3,Lost
8,3,2072.7400000000002,4,3,4,11,Champions
38,1,348.78,3,1,2,6,At Risk
56,1,282.45,2,1,2,5,At Risk
18,11,4569.75,3,4,4,11,Champions
37,1,121.18,3,1,1,5,At Risk
29,8,1040.17,3,4,3,10,Loyal Customers
6,10,1429.11,4,4,4,12,Champions
259,1,71.4,1,1,1,3,Lost
31,3,1362.02,3,3,4,10,Loyal Customers
328,1,154.02,1,1,1,3,Lost
3,1,99.60000000000001,4,1,1,6,At Risk
10,2,167.28,4,2,1,7,Potential Loyalist
87,2,859.14,2,2,3,7,Potential Loyalist
53,1,100.92999999999999,2,1,1,4,Lost
127,1,60.7,2,1,1,4,Lost
3,4,1704.03,4,3,4,11,Champions
2,6,3181.55,4,4,4,12,Champions
10,17,2255.54,4,4,4,12,Champions
13,3,607.27,4,3,3,10,Loyal Customers
1,4,798.68,4,3,3,10,Loyal Customers
7,2,250.26000000000002,4,2,2,8,Potential Loyalist
50,6,1075.8,2,4,3,9,Loyal Customers
22,7,4798.16,3,4,4,11,Champions
85,1,293.0,2,1,2,5,At Risk
2,3,483.42,4,3,3,10,Loyal Customers
11,3,528.73,4,3,3,10,Loyal Customers
48,5,1197.28,3,4,4,11,Champions
259,1,10.5,1,1,1,3,Lost
114,1,52.02,2,1,1,4,Lost
119,1,56.76,2,1,1,4,Lost
70,4,506.04,2,3,3,8,Potential Loyalist
232,2,570.71,1,2,3,6,At Risk
192,1,62.4,1,1,1,3,Lost
52,2,1807.92,2,2,4,8,Potential Loyalist
265,1,85.51,1,1,1,3,Lost
193,1,257.7,1,1,2,4,Lost
217,1,123.15,1,1,1,3,Lost
20,13,1753.28,3,4,4,11,Champions
4,7,982.16,4,4,3,11,Champions
66,2,477.2,2,2,3,7,Potential Loyalist
204,1,870.57,1,1,3,5,At Risk
16,2,592.33,4,2,3,9,Loyal Customers
15,3,493.68,4,3,3,10,Loyal Customers
253,1,292.12,1,1,2,4,Lost
88,4,616.7,2,3,3,8,Potential Loyalist
104,3,270.40000000000003,2,3,2,7,Potential Loyalist
195,1,480.02000000000004,1,1,3,5,At Risk
84,1,94.79,2,1,1,4,Lost
42,1,259.85,3,1,2,6,At Risk
10,6,844.31,4,4,3,11,Champions
9,4,474.72,4,3,3,10,Loyal Customers
116,2,434.21,2,2,2,6,At Risk
85,1,82.23,2,1,1,4,Lost
148,2,380.15999999999997,1,2,2,5,At Risk
1,2,198.46,4,2,1,7,Potential Loyalist
3,3,509.48,4,3,3,10,Loyal Customers
53,1,258.32,2,1,2,5,At Risk
53,1,82.32000000000001,2,1,1,4,Lost
260,2,670.5,1,2,3,6,At Risk
255,1,132.29,1,1,1,3,Lost
3,32,6395.45,4,4,4,12,Champions
45,5,1247.52,3,4,4,11,Champions
3,12,2290.61,4,4,4,12,Champions
9,17,3478.9900000000002,4,4,4,12,Champions
9,10,2847.0,4,4,4,12,Champions
3,14,4148.31,4,4,4,12,Champions
29,1,217.38,3,1,2,6,At Risk
23,2,205.66000000000003,3,2,1,6,At Risk
105,1,128.54,2,1,1,4,Lost
55,2,462.98,2,2,3,7,Potential Loyalist
7,3,159.4,4,3,1,8,Potential Loyalist
32,1,459.86,3,1,3,7,Potential Loyalist
70,1,137.75,2,1,1,4,Lost
114,3,739.85,2,3,3,8,Potential Loyalist
10,3,726.94,4,3,3,10,Loyal Customers
51,2,93.66,2,2,1,5,At Risk
322,1,148.74,1,1,1,3,Lost
15,4,2566.02,4,3,4,11,Champions
147,1,338.41,1,1,2,4,Lost
30,2,418.45,3,2,2,7,Potential Loyalist
181,2,726.39,1,2,3,6,At Risk
351,1,168.3,1,1,1,3,Lost
129,1,53.4,2,1,1,4,Lost
15,3,1420.07,4,3,4,11,Champions
260,1,82.80000000000001,1,1,1,3,Lost
161,1,371.89,1,1,2,4,Lost
95,4,507.74,2,3,3,8,Potential Loyalist
343,1,244.85000000000002,1,1,2,4,Lost
13,9,827.85,4,4,3,11,Champions
112,1,15.0,2,1,1,4,Lost
14,3,1092.43,4,3,3,10,Loyal Customers
37,4,1183.7,3,3,4,10,Loyal Customers
20,3,1015.73,3,3,3,9,Loyal Customers
142,1,300.36,2,1,2,5,At Risk
14,5,1475.1200000000001,4,4,4,12,Champions
55,2,509.97,2,2,3,7,Potential Loyalist
29,4,580.49,3,3,3,9,Loyal Customers
58,6,1781.8300000000002,2,4,4,10,Loyal Customers
29,1,229.66,3,1,2,6,At Risk
9,25,9167.210000000001,4,4,4,12,Champions
69,4,1548.7,2,3,4,9,Loyal Customers
78,1,259.04,2,1,2,5,At Risk
9,1,199.48000000000002,4,1,1,6,At Risk
13,3,355.3,4,3,2,9,Loyal Customers
28,8,1036.95,3,4,3,10,Loyal Customers
73,1,471.3,2,1,3,6,At Risk
30,8,2690.07,3,4,4,11,Champions
308,1,235.68,1,1,2,4,Lost
23,2,312.48,3,2,2,7,Potential Loyalist
84,3,961.38,2,3,3,8,Potential Loyalist
6,1,338.4,4,1,2,7,Potential Loyalist
74,3,3165.62,2,3,4,9,Loyal Customers
69,1,752.8000000000001,2,1,3,6,At Risk
149,1,316.47,1,1,2,4,Lost
192,1,664.42,1,1,3,5,At Risk
37,6,2161.56,3,4,4,11,Champions
252,1,603.55,1,1,3,5,At Risk
169,1,290.93,1,1,2,4,Lost
59,3,1716.32,2,3,4,9,Loyal Customers
279,1,299.70000000000005,1,1,2,4,Lost
62,1,148.79999999999998,2,1,1,4,Lost
56,1,233.76,2,1,2,5,At Risk
2,1,197.32,4,1,1,6,At Risk
8,2,652.77,4,2,3,9,Loyal Customers
58,1,323.94,2,1,2,5,At Risk
52,1,316.17999999999995,2,1,2,5,At Risk
63,1,684.91,2,1,3,6,At Risk
114,1,516.0,2,1,3,6,At Risk
72,1,548.59,2,1,3,6,At Risk
249,1,492.15,1,1,3,5,At Risk
260,1,304.71,1,1,2,4,Lost
55,1,307.06,2,1,2,5,At Risk
1,4,2686.64,4,3,4,11,Champions
9,2,834.89,4,2,3,9,Loyal Customers
62,1,134.95999999999998,2,1,1,4,Lost
25,2,1718.8700000000001,3,2,4,9,Loyal Customers
248,2,430.18,1,2,2,5,At Risk
357,1,198.38000000000002,1,1,1,3,Lost
363,1,604.75,1,1,3,5,At Risk
81,1,290.04,2,1,2,5,At Risk
52,3,2726.17,2,3,4,9,Loyal Customers
80,1,607.1800000000001,2,1,3,6,At Risk
91,3,834.3100000000001,2,3,3,8,Potential Loyalist
18,3,521.36,3,3,3,9,Loyal Customers
23,6,3045.75,3,4,4,11,Champions
272,1,197.14000000000001,1,1,1,3,Lost
22,7,2877.66,3,4,4,11,Champions
321,1,403.07,1,1,2,4,Lost
123,2,505.45,2,2,3,7,Potential Loyalist
3,3,700.66,4,3,3,10,Loyal Customers
66,1,304.68,2,1,2,5,At Risk
45,7,1772.59,3,4,4,11,Champions
177,1,251.28,1,1,2,4,Lost
21,2,936.69,3,2,3,8,Potential Loyalist
64,4,1118.81,2,3,4,9,Loyal Customers
184,1,383.57,1,1,2,4,Lost
119,2,587.23,2,2,3,7,Potential Loyalist
9,1,30.0,4,1,1,6,At Risk
204,1,217.81,1,1,2,4,Lost
66,3,363.351,2,3,2,7,Potential Loyalist
3,50,8979.66,4,4,4,12,Champions
16,4,588.34,4,3,3,10,Loyal Customers
99,1,203.60000000000002,2,1,1,4,Lost
125,2,568.5,2,2,3,7,Potential Loyalist
35,2,576.5,3,2,3,8,Potential Loyalist
197,1,106.8,1,1,1,3,Lost
3,18,4699.71,4,4,4,12,Champions
55,1,221.06,2,1,2,5,At Risk
141,2,87.6,2,2,1,5,At Risk
32,2,1575.29,3,2,4,9,Loyal Customers
56,1,2292.0,2,1,4,7,Potential Loyalist
100,3,1057.45,2,3,3,8,Potential Loyalist
2,9,2804.04,4,4,4,12,Champions
11,3,445.34,4,3,2,9,Loyal Customers
2,1,176.57,4,1,1,6,At Risk
2,4,816.69,4,3,3,10,Loyal Customers
10,2,574.25,4,2,3,9,Loyal Customers
59,2,814.8,2,2,3,7,Potential Loyalist
66,2,179.04000000000002,2,2,1,5,At Risk
16,6,1463.28,4,4,4,12,Champions
6,7,2384.36,4,4,4,12,Champions
247,1,273.27,1,1,2,4,Lost
83,1,195.36,2,1,1,4,Lost
15,3,1026.69,4,3,3,10,Loyal Customers
8,6,3032.1800000000003,4,4,4,12,Champions
15,1,291.88,4,1,2,7,Potential Loyalist
18,6,1272.48,3,4,4,11,Champions
18,5,2627.85,3,4,4,11,Champions
157,2,245.57999999999998,1,2,2,5,At Risk
16,2,660.19,4,2,3,9,Loyal Customers
9,5,1180.1200000000001,4,4,4,12,Champions
15,13,6812.05,4,4,4,12,Champions
21,2,183.44,3,2,1,6,At Risk
30,3,329.8,3,3,2,8,Potential Loyalist
244,1,135.0,1,1,1,3,Lost
50,1,606.73,2,1,3,6,At Risk
176,1,197.70000000000002,1,1,1,3,Lost
2,2,871.8100000000001,4,2,3,9,Loyal Customers
10,35,3563.87,4,4,4,12,Champions
91,2,165.0,2,2,1,5,At Risk
13,2,1368.6,4,2,4,10,Loyal Customers
52,2,326.96,2,2,2,6,At Risk
228,1,187.99,1,1,1,3,Lost
183,4,1115.66,1,3,4,8,Potential Loyalist
170,2,697.67,1,2,3,6,At Risk
29,6,1249.8899999999999,3,4,4,11,Champions
192,2,261.15,1,2,2,5,At Risk
37,5,1680.26,3,4,4,11,Champions
224,1,184.64,1,1,1,3,Lost
57,1,140.34,2,1,1,4,Lost
233,1,202.5,1,1,1,3,Lost
225,1,394.44,1,1,2,4,Lost
70,3,999.55,2,3,3,8,Potential Loyalist
49,3,361.1,3,3,2,8,Potential Loyalist
9,13,6585.43,4,4,4,12,Champions
97,3,175.44,2,3,1,6,At Risk
43,10,943.34,3,4,3,10,Loyal Customers
128,3,729.24,2,3,3,8,Potential Loyalist
279,1,14.850000000000001,1,1,1,3,Lost
303,1,296.1,1,1,2,4,Lost
27,4,1403.43,3,3,4,10,Loyal Customers
2,2,563.63,4,2,3,9,Loyal Customers
274,2,348.05,1,2,2,5,At Risk
9,5,609.09,4,4,3,11,Champions
15,3,1010.8,4,3,3,10,Loyal Customers
279,1,844.72,1,1,3,5,At Risk
8,3,272.1,4,3,2,9,Loyal Customers
63,1,192.95,2,1,1,4,Lost
56,1,260.48,2,1,2,5,At Risk
64,4,3042.26,2,3,4,9,Loyal Customers
308,2,379.45,1,2,2,5,At Risk
90,3,1592.13,2,3,4,9,Loyal Customers
235,1,66.42,1,1,1,3,Lost
44,4,595.78,3,3,3,9,Loyal Customers
37,3,1262.08,3,3,4,10,Loyal Customers
252,1,228.51000000000002,1,1,2,4,Lost
118,1,132.6,2,1,1,4,Lost
65,1,152.20000000000002,2,1,1,4,Lost
64,4,833.82,2,3,3,8,Potential Loyalist
64,2,607.91,2,2,3,7,Potential Loyalist
51,3,1839.49,2,3,4,9,Loyal Customers
77,1,567.72,2,1,3,6,At Risk
69,1,78.95,2,1,1,4,Lost
50,6,1582.45,2,4,4,10,Loyal Customers
2,1,279.93,4,1,2,7,Potential Loyalist
22,1,125.80000000000001,3,1,1,5,At Risk
25,5,2181.58,3,4,4,11,Champions
32,5,580.94,3,4,3,10,Loyal Customers
6,1,90.0,4,1,1,6,At Risk
25,7,1906.0,3,4,4,11,Champions
70,2,206.06,2,2,2,6,At Risk
197,2,357.7,1,2,2,5,At Risk
25,1,210.31,3,1,2,6,At Risk
174,3,246.94,1,3,2,6,At Risk
24,23,4829.18,3,4,4,11,Champions
1,5,1670.51,4,4,4,12,Champions
35,5,699.45,3,4,3,10,Loyal Customers
77,3,446.52,2,3,2,7,Potential Loyalist
31,2,221.26,3,2,2,7,Potential Loyalist
4,3,553.29,4,3,3,10,Loyal Customers
88,2,512.84,2,2,3,7,Potential Loyalist
17,7,793.85,4,4,3,11,Champions
311,1,53.550000000000004,1,1,1,3,Lost
58,12,2227.55,2,4,4,10,Loyal Customers
65,4,2210.34,2,3,4,9,Loyal Customers
20,2,524.06,3,2,3,8,Potential Loyalist
15,3,451.18,4,3,2,9,Loyal Customers
207,1,39.01,1,1,1,3,Lost
73,3,1459.6100000000001,2,3,4,9,Loyal Customers
76,2,375.13,2,2,2,6,At Risk
346,2,892.94,1,2,3,6,At Risk
11,2,240.22,4,2,2,8,Potential Loyalist
32,2,864.76,3,2,3,8,Potential Loyalist
165,1,175.0,1,1,1,3,Lost
9,2,286.1,4,2,2,8,Potential Loyalist
235,1,211.64,1,1,2,4,Lost
4,12,2017.27,4,4,4,12,Champions
197,1,590.9300000000001,1,1,3,5,At Risk
42,2,238.11,3,2,2,7,Potential Loyalist
15,5,674.5699999999999,4,4,3,11,Champions
2,17,1797.66,4,4,4,12,Champions
17,4,1353.5,4,3,4,11,Champions
6,2,321.29,4,2,2,8,Potential Loyalist
301,1,56.95,1,1,1,3,Lost
147,1,691.05,1,1,3,5,At Risk
298,1,75.75,1,1,1,3,Lost
55,1,168.0,2,1,1,4,Lost
7,9,2331.81,4,4,4,12,Champions
6,2,256.05,4,2,2,8,Potential Loyalist
3,6,1417.5,4,4,4,12,Champions
56,3,809.58,2,3,3,8,Potential Loyalist
27,3,159.51,3,3,1,7,Potential Loyalist
100,5,1497.13,2,4,4,10,Loyal Customers
44,1,396.97,3,1,2,6,At Risk
4,1,334.4,4,1,2,7,Potential Loyalist
39,1,134.07,3,1,1,5,At Risk
2,19,3568.08,4,4,4,12,Champions
304,1,66.52,1,1,1,3,Lost
37,2,663.08,3,2,3,8,Potential Loyalist
56,1,398.65000000000003,2,1,2,5,At Risk
18,1,129.44,3,1,1,5,At Risk
20,2,152.22,3,2,1,6,At Risk
32,1,565.5600000000001,3,1,3,7,Potential Loyalist
4,7,891.78,4,4,3,11,Champions
81,3,974.1600000000001,2,3,3,8,Potential Loyalist
16,4,1076.8600000000001,4,3,3,10,Loyal Customers
310,1,385.89,1,1,2,4,Lost
32,3,444.04,3,3,2,8,Potential Loyalist
165,1,154.54,1,1,1,3,Lost
108,1,209.85,2,1,2,5,At Risk
22,5,392.05,3,4,2,9,Loyal Customers
244,1,241.32999999999998,1,1,2,4,Lost
51,5,1203.83,2,4,4,10,Loyal Customers
134,1,281.01,2,1,2,5,At Risk
67,6,825.14,2,4,3,9,Loyal Customers
91,5,332.5,2,4,2,8,Potential Loyalist
16,5,1766.71,4,4,4,12,Champions
25,5,1142.21,3,4,4,11,Champions
59,1,1031.43,2,1,3,6,At Risk
28,5,720.83,3,4,3,10,Loyal Customers
44,3,741.25,3,3,3,9,Loyal Customers
7,1,97.14,4,1,1,6,At Risk
66,1,646.34,2,1,3,6,At Risk
207,1,268.55,1,1,2,4,Lost
23,3,468.44,3,3,3,9,Loyal Customers
8,4,1979.0900000000001,4,3,4,11,Champions
112,1,30.599999999999998,2,1,1,4,Lost
1,4,1164.52,4,3,4,11,Champions
248,2,333.85,1,2,2,5,At Risk
8,6,1567.29,4,4,4,12,Champions
31,1,63.3,3,1,1,5,At Risk
37,3,1003.64,3,3,3,9,Loyal Customers
35,6,2261.97,3,4,4,11,Champions
106,2,753.22,2,2,3,7,Potential Loyalist
156,2,319.79,1,2,2,5,At Risk
2,2,321.0,4,2,2,8,Potential Loyalist
1,5,1735.85,4,4,4,12,Champions
197,2,1225.47,1,2,4,7,Potential Loyalist
77,3,663.56,2,3,3,8,Potential Loyalist
171,1,91.07,1,1,1,3,Lost
52,3,67.65,2,3,1,6,At Risk
141,1,258.17,2,1,2,5,At Risk
2,20,4041.09,4,4,4,12,Champions
42,2,160.2,3,2,1,6,At Risk
67,1,333.2,2,1,2,5,At Risk
293,2,186.39000000000001,1,2,1,4,Lost
10,2,307.27,4,2,2,8,Potential Loyalist
143,2,473.38,2,2,3,7,Potential Loyalist
143,1,72.56,2,1,1,4,Lost
31,3,1474.46,3,3,4,10,Loyal Customers
9,4,796.0300000000001,4,3,3,10,Loyal Customers
179,1,34.0,1,1,1,3,Lost
277,1,67.23,1,1,1,3,Lost
45,1,5.930000000000001,3,1,1,5,At Risk
174,1,72.0,1,1,1,3,Lost
55,1,15.0,2,1,1,4,Lost
51,1,81.60000000000001,2,1,1,4,Lost
16,2,749.64,4,2,3,9,Loyal Customers
37,18,2559.21,3,4,4,11,Champions
23,13,1616.53,3,4,4,11,Champions
30,1,151.29999999999998,3,1,1,5,At Risk
147,1,70.08000000000001,1,1,1,3,Lost
18,10,1856.6200000000001,3,4,4,11,Champions
14,8,1682.82,4,4,4,12,Champions
136,2,357.68,2,2,2,6,At Risk
294,1,290.89,1,1,2,4,Lost
258,2,581.36,1,2,3,6,At Risk
263,1,272.01,1,1,2,4,Lost
28,11,4190.74,3,4,4,11,Champions
23,1,94.56,3,1,1,5,At Risk
210,2,232.16000000000003,1,2,2,5,At Risk
238,1,88.2,1,1,1,3,Lost
272,5,1018.2,1,4,3,8,Potential Loyalist
261,1,138.28,1,1,1,3,Lost
24,6,1088.32,3,4,3,10,Loyal Customers
238,2,242.4,1,2,2,5,At Risk
7,5,855.41,4,4,3,11,Champions
108,4,685.8,2,3,3,8,Potential Loyalist
28,1,470.94,3,1,3,7,Potential Loyalist
123,3,2004.68,2,3,4,9,Loyal Customers
209,1,150.10000000000002,1,1,1,3,Lost
41,7,1203.52,3,4,4,11,Champions
30,2,429.11999999999995,3,2,2,7,Potential Loyalist
20,2,285.78000000000003,3,2,2,7,Potential Loyalist
28,6,437.44,3,4,2,9,Loyal Customers
127,2,522.55,2,2,3,7,Potential Loyalist
211,2,511.59000000000003,1,2,3,6,At Risk
20,1,491.86,3,1,3,7,Potential Loyalist
16,4,1970.99,4,3,4,11,Champions
252,1,271.78000000000003,1,1,2,4,Lost
192,1,185.65,1,1,1,3,Lost
10,1,125.10000000000001,4,1,1,6,At Risk
232,1,234.71,1,1,2,4,Lost
63,3,405.63,2,3,2,7,Potential Loyalist
8,12,1918.81,4,4,4,12,Champions
80,6,641.4,2,4,3,9,Loyal Customers
87,2,992.1,2,2,3,7,Potential Loyalist
154,1,241.35999999999999,1,1,2,4,Lost
87,4,328.7,2,3,2,7,Potential Loyalist
45,3,243.68,3,3,2,8,Potential Loyalist
280,1,75.6,1,1,1,3,Lost
116,6,723.74,2,4,3,9,Loyal Customers
279,1,710.66,1,1,3,5,At Risk
143,2,129.6,2,2,1,5,At Risk
1,8,1534.45,4,4,4,12,Champions
14,11,2267.84,4,4,4,12,Champions
3,7,1955.39,4,4,4,12,Champions
25,2,439.59000000000003,3,2,2,7,Potential Loyalist
46,2,286.79,3,2,2,7,Potential Loyalist
42,2,974.65,3,2,3,8,Potential Loyalist
210,1,133.2,1,1,1,3,Lost
55,1,308.40000000000003,2,1,2,5,At Risk
62,3,1352.96,2,3,4,9,Loyal Customers
17,35,7396.96,4,4,4,12,Champions
29,9,1820.5500000000002,3,4,4,11,Champions
56,4,2188.72,2,3,4,9,Loyal Customers
25,3,1027.43,3,3,3,9,Loyal Customers
73,1,314.15000000000003,2,1,2,5,At Risk
16,19,3190.51,4,4,4,12,Champions
95,1,178.7,2,1,1,4,Lost
162,1,30.48,1,1,1,3,Lost
242,1,68.54,1,1,1,3,Lost
4,6,766.56,4,4,3,11,Champions
104,5,247.26,2,4,2,8,Potential Loyalist
359,1,148.8,1,1,1,3,Lost
67,2,231.55,2,2,2,6,At Risk
58,2,183.05,2,2,1,5,At Risk
9,23,1996.51,4,4,4,12,Champions
108,2,649.06,2,2,3,7,Potential Loyalist
301,1,486.62,1,1,3,5,At Risk
58,1,247.1,2,1,2,5,At Risk
130,3,1068.52,2,3,3,8,Potential Loyalist
247,1,277.07,1,1,2,4,Lost
22,7,2303.89,3,4,4,11,Champions
55,1,218.13000000000002,2,1,2,5,At Risk
359,1,80.8,1,1,1,3,Lost
38,4,951.2,3,3,3,9,Loyal Customers
297,1,60.300000000000004,1,1,1,3,Lost
20,2,609.16,3,2,3,8,Potential Loyalist
34,3,452.1,3,3,2,8,Potential Loyalist
31,4,1050.26,3,3,3,9,Loyal Customers
84,2,1334.22,2,2,4,8,Potential Loyalist
14,4,3007.46,4,3,4,11,Champions
15,2,420.42,4,2,2,8,Potential Loyalist
20,2,328.98,3,2,2,7,Potential Loyalist
293,3,624.75,1,3,3,7,Potential Loyalist
136,2,321.89,2,2,2,6,At Risk
32,1,415.08,3,1,2,6,At Risk
10,2,683.36,4,2,3,9,Loyal Customers
24,5,1171.86,3,4,4,11,Champions
168,1,102.30000000000001,1,1,1,3,Lost
49,3,239.9,3,3,2,8,Potential Loyalist
14,1,168.45,4,1,1,6,At Risk
8,4,527.17,4,3,3,10,Loyal Customers
11,1,52.199999999999996,4,1,1,6,At Risk
151,1,226.4,1,1,2,4,Lost
17,4,692.37,4,3,3,10,Loyal Customers
203,2,226.24,1,2,2,5,At Risk
109,3,363.49,2,3,2,7,Potential Loyalist
50,9,2555.65,2,4,4,10,Loyal Customers
3,1,345.12,4,1,2,7,Potential Loyalist
56,1,157.86,2,1,1,4,Lost
16,3,733.16,4,3,3,10,Loyal Customers
43,2,1325.55,3,2,4,9,Loyal Customers
121,1,1478.98,2,1,4,7,Potential Loyalist
87,3,1536.08,2,3,4,9,Loyal Customers
49,1,547.3000000000001,3,1,3,7,Potential Loyalist
16,23,2441.16,4,4,4,12,Champions
160,3,120.3,1,3,1,5,At Risk
49,1,182.67,3,1,1,5,At Risk
318,1,172.76000000000002,1,1,1,3,Lost
6,4,841.5,4,3,3,10,Loyal Customers
10,8,2131.96,4,4,4,12,Champions
239,1,264.88,1,1,2,4,Lost
50,4,437.81,2,3,2,7,Potential Loyalist
66,1,145.67000000000002,2,1,1,4,Lost
23,3,719.74,3,3,3,9,Loyal Customers
30,1,428.37,3,1,2,6,At Risk
115,4,2468.25,2,3,4,9,Loyal Customers
32,7,1679.29,3,4,4,11,Champions
14,13,5070.75,4,4,4,12,Champions
111,3,324.05,2,3,2,7,Potential Loyalist
349,1,247.45000000000002,1,1,2,4,Lost
45,5,1477.82,3,4,4,11,Champions
55,1,98.80000000000001,2,1,1,4,Lost
78,1,17.4,2,1,1,4,Lost
46,1,1031.94,3,1,3,7,Potential Loyalist
13,13,2927.18,4,4,4,12,Champions
9,13,2902.56,4,4,4,12,Champions
3,4,613.1,4,3,3,10,Loyal Customers
2,5,2176.33,4,4,4,12,Champions
81,3,436.1,2,3,2,7,Potential Loyalist
181,2,390.2,1,2,2,5,At Risk
63,1,218.56,2,1,2,5,At Risk
196,1,293.95,1,1,2,4,Lost
111,2,505.98,2,2,3,7,Potential Loyalist
84,1,416.90000000000003,2,1,2,5,At Risk
14,7,1291.26,4,4,4,12,Champions
18,4,410.01,3,3,2,8,Potential Loyalist
289,1,195.70000000000002,1,1,1,3,Lost
15,2,430.55,4,2,2,8,Potential Loyalist
20,4,2144.67,3,3,4,10,Loyal Customers
42,1,311.16,3,1,2,6,At Risk
317,1,138.93,1,1,1,3,Lost
8,2,337.52,4,2,2,8,Potential Loyalist
184,2,553.95,1,2,3,6,At Risk
64,5,2365.83,2,4,4,10,Loyal Customers
29,2,332.64,3,2,2,7,Potential Loyalist
71,4,1948.9,2,3,4,9,Loyal Customers
136,8,1872.71,2,4,4,10,Loyal Customers
3,2,604.83,4,2,3,9,Loyal Customers
41,2,252.14000000000001,3,2,2,7,Potential Loyalist
41,2,565.1,3,2,3,8,Potential Loyalist
51,2,331.86,2,2,2,6,At Risk
343,1,81.6,1,1,1,3,Lost
45,1,317.63,3,1,2,6,At Risk
9,5,1348.63,4,4,4,12,Champions
84,4,411.1,2,3,2,7,Potential Loyalist
15,1,150.10000000000002,4,1,1,6,At Risk
66,1,348.99,2,1,2,5,At Risk
2,4,336.47,4,3,2,9,Loyal Customers
161,2,285.45,1,2,2,5,At Risk
49,2,337.34,3,2,2,7,Potential Loyalist
87,2,956.13,2,2,3,7,Potential Loyalist
286,1,195.8,1,1,1,3,Lost
101,2,576.99,2,2,3,7,Potential Loyalist
255,1,818.65,1,1,3,5,At Risk
171,1,369.74,1,1,2,4,Lost
161,1,128.25,1,1,1,3,Lost
27,1,71.66,3,1,1,5,At Risk
15,3,466.37,4,3,3,10,Loyal Customers
9,4,648.5600000000001,4,3,3,10,Loyal Customers
13,5,1389.88,4,4,4,12,Champions
71,3,57.33,2,3,1,6,At Risk
57,1,90.6,2,1,1,4,Lost
352,1,70.19999999999999,1,1,1,3,Lost
16,5,1620.33,4,4,4,12,Champions
3,4,437.65999999999997,4,3,2,9,Loyal Customers
168,3,504.09000000000003,1,3,3,7,Potential Loyalist
209,2,2300.811,1,2,4,7,Potential Loyalist
107,1,104.36,2,1,1,4,Lost
62,1,144.16,2,1,1,4,Lost
146,2,239.31,1,2,2,5,At Risk
46,4,586.34,3,3,3,9,Loyal Customers
71,3,512.75,2,3,3,8,Potential Loyalist
13,2,230.22,4,2,2,8,Potential Loyalist
13,2,82.1,4,2,1,7,Potential Loyalist
300,4,469.02,1,3,3,7,Potential Loyalist
137,1,35.7,2,1,1,4,Lost
8,16,5913.76,4,4,4,12,Champions
10,8,2502.56,4,4,4,12,Champions
62,2,174.35,2,2,1,5,At Risk
279,1,186.75,1,1,1,3,Lost
41,1,413.59000000000003,3,1,2,6,At Risk
23,6,2280.69,3,4,4,11,Champions
198,1,227.96,1,1,2,4,Lost
6,2,132.53,4,2,1,7,Potential Loyalist
65,1,869.87,2,1,3,6,At Risk
52,1,116.78,2,1,1,4,Lost
31,4,1424.6,3,3,4,10,Loyal Customers
31,9,1277.8,3,4,4,11,Champions
18,4,277.43,3,3,2,8,Potential Loyalist
6,14,6715.67,4,4,4,12,Champions
9,1,186.06,4,1,1,6,At Risk
11,6,3170.07,4,4,4,12,Champions
57,2,462.21,2,2,3,7,Potential Loyalist
205,1,292.58,1,1,2,4,Lost
4,6,724.93,4,4,3,11,Champions
22,1,76.8,3,1,1,5,At Risk
34,8,2127.26,3,4,4,11,Champions
31,5,1937.8400000000001,3,4,4,11,Champions
7,5,1308.99,4,4,4,12,Champions
2,12,3506.81,4,4,4,12,Champions
203,1,262.2,1,1,2,4,Lost
37,3,828.0,3,3,3,9,Loyal Customers
126,2,368.59999999999997,2,2,2,6,At Risk
35,7,2921.96,3,4,4,11,Champions
1,5,1242.9,4,4,4,12,Champions
107,3,503.6,2,3,3,8,Potential Loyalist
190,2,646.8100000000001,1,2,3,6,At Risk
269,1,328.8,1,1,2,4,Lost
102,3,435.58,2,3,2,7,Potential Loyalist
69,1,304.42,2,1,2,5,At Risk
44,1,607.62,3,1,3,7,Potential Loyalist
153,4,2642.62,1,3,4,8,Potential Loyalist
38,3,991.01,3,3,3,9,Loyal Customers
8,2,573.86,4,2,3,9,Loyal Customers
147,3,495.7,1,3,3,7,Potential Loyalist
217,1,396.8,1,1,2,4,Lost
242,1,253.24,1,1,2,4,Lost
113,2,298.45,2,2,2,6,At Risk
52,1,104.82,2,1,1,4,Lost
55,2,315.66,2,2,2,6,At Risk
10,8,1595.95,4,4,4,12,Champions
13,15,5657.29,4,4,4,12,Champions
8,10,2118.77,4,4,4,12,Champions
14,3,346.77,4,3,2,9,Loyal Customers
20,5,876.07,3,4,3,10,Loyal Customers
276,1,451.25,1,1,2,4,Lost
168,2,139.25,1,2,1,4,Lost
70,3,1560.38,2,3,4,9,Loyal Customers
25,1,82.6,3,1,1,5,At Risk
32,12,1932.66,3,4,4,11,Champions
258,1,141.41,1,1,1,3,Lost
18,4,538.52,3,3,3,9,Loyal Customers
276,1,47.71,1,1,1,3,Lost
191,3,260.85,1,3,2,6,At Risk
297,1,399.85,1,1,2,4,Lost
8,4,4687.74,4,3,4,11,Champions
23,2,746.36,3,2,3,8,Potential Loyalist
9,21,9430.01,4,4,4,12,Champions
11,1,173.66,4,1,1,6,At Risk
151,1,41.75,1,1,1,3,Lost
57,1,92.46,2,1,1,4,Lost
98,1,149.14,2,1,1,4,Lost
7,22,5568.63,4,4,4,12,Champions
15,15,4107.2699999999995,4,4,4,12,Champions
258,1,132.6,1,1,1,3,Lost
14,15,2387.7400000000002,4,4,4,12,Champions
1,9,2289.89,4,4,4,12,Champions
21,5,803.15,3,4,3,10,Loyal Customers
258,1,114.3,1,1,1,3,Lost
55,2,275.04,2,2,2,6,At Risk
312,1,248.85000000000002,1,1,2,4,Lost
11,6,863.45,4,4,3,11,Champions
24,1,151.04,3,1,1,5,At Risk
11,2,538.48,4,2,3,9,Loyal Customers
121,1,105.52,2,1,1,4,Lost
32,5,354.05,3,4,2,9,Loyal Customers
93,6,936.7199999999999,2,4,3,9,Loyal Customers
116,1,147.25,2,1,1,4,Lost
24,1,45.599999999999994,3,1,1,5,At Risk
294,2,695.05,1,2,3,6,At Risk
356,1,127.05,1,1,1,3,Lost
118,6,459.37,2,4,3,9,Loyal Customers
1,15,3280.11,4,4,4,12,Champions
2,12,15700.62,4,4,4,12,Champions
48,1,113.3,3,1,1,5,At Risk
15,12,3526.65,4,4,4,12,Champions
4,1,420.89,4,1,2,7,Potential Loyalist
3,16,31298.1,4,4,4,12,Champions
28,1,147.35,3,1,1,5,At Risk
8,11,2668.76,4,4,4,12,Champions
129,1,147.2,2,1,1,4,Lost
286,1,2.95,1,1,1,3,Lost
3,4,744.38,4,3,3,10,Loyal Customers
157,1,69.71,1,1,1,3,Lost
230,1,1089.14,1,1,3,5,At Risk
43,7,2413.2200000000003,3,4,4,11,Champions
22,2,544.36,3,2,3,8,Potential Loyalist
64,1,144.2,2,1,1,4,Lost
28,10,2927.37,3,4,4,11,Champions
87,2,63.3,2,2,1,5,At Risk
14,6,2505.16,4,4,4,12,Champions
14,3,453.12,4,3,2,9,Loyal Customers
322,1,195.13,1,1,1,3,Lost
11,5,1091.04,4,4,3,11,Champions
135,1,90.0,2,1,1,4,Lost
2,3,1710.22,4,3,4,11,Champions
2,3,2396.53,4,3,4,11,Champions
2,1,183.4,4,1,1,6,At Risk
114,3,503.01,2,3,3,8,Potential Loyalist
52,2,625.0,2,2,3,7,Potential Loyalist
9,4,924.48,4,3,3,10,Loyal Customers
311,1,363.41,1,1,2,4,Lost
6,10,2458.58,4,4,4,12,Champions
121,3,499.28999999999996,2,3,3,8,Potential Loyalist
24,13,2456.89,3,4,4,11,Champions
55,1,638.21,2,1,3,6,At Risk
38,1,278.28,3,1,2,6,At Risk
23,1,528.24,3,1,3,7,Potential Loyalist
51,3,676.0300000000001,2,3,3,8,Potential Loyalist
365,1,280.95,1,1,2,4,Lost
125,1,64.8,2,1,1,4,Lost
73,4,1895.04,2,3,4,9,Loyal Customers
69,2,61.8,2,2,1,5,At Risk
225,1,29.700000000000003,1,1,1,3,Lost
212,1,421.12,1,1,2,4,Lost
27,2,584.74,3,2,3,8,Potential Loyalist
67,2,602.57,2,2,3,7,Potential Loyalist
231,2,682.92,1,2,3,6,At Risk
258,1,118.75,1,1,1,3,Lost
1,41,18300.66,4,4,4,12,Champions
11,2,412.72,4,2,2,8,Potential Loyalist
32,1,397.38,3,1,2,6,At Risk
11,11,4491.04,4,4,4,12,Champions
207,3,890.92,1,3,3,7,Potential Loyalist
165,2,198.11,1,2,1,4,Lost
79,4,1051.6100000000001,2,3,3,8,Potential Loyalist
72,1,374.4,2,1,2,5,At Risk
267,1,84.29,1,1,1,3,Lost
31,4,525.09,3,3,3,9,Loyal Customers
90,1,308.44,2,1,2,5,At Risk
2,4,222.34,4,3,2,9,Loyal Customers
25,1,124.51,3,1,1,5,At Risk
51,3,2177.5,2,3,4,9,Loyal Customers
289,4,517.2,1,3,3,7,Potential Loyalist
78,4,450.77,2,3,2,7,Potential Loyalist
20,6,1145.41,3,4,4,11,Champions
32,2,566.88,3,2,3,8,Potential Loyalist
2,25,1779.8200000000002,4,4,4,12,Champions
58,1,245.59,2,1,2,5,At Risk
323,1,12.75,1,1,1,3,Lost
22,6,1763.8600000000001,3,4,4,11,Champions
8,14,3512.52,4,4,4,12,Champions
2,12,3873.14,4,4,4,12,Champions
59,2,737.15,2,2,3,7,Potential Loyalist
10,20,9018.01,4,4,4,12,Champions
98,1,73.72,2,1,1,4,Lost
10,4,504.6,4,3,3,10,Loyal Customers
210,1,10.2,1,1,1,3,Lost
52,7,522.64,2,4,3,9,Loyal Customers
8,2,288.2,4,2,2,8,Potential Loyalist
231,1,302.65999999999997,1,1,2,4,Lost
86,1,101.14,2,1,1,4,Lost
2,6,1098.55,4,4,3,11,Champions
97,6,1616.1200000000001,2,4,4,10,Loyal Customers
45,9,1761.15,3,4,4,11,Champions
22,5,938.14,3,4,3,10,Loyal Customers
3,6,1650.47,4,4,4,12,Champions
8,2,785.9,4,2,3,9,Loyal Customers
3,16,1228.05,4,4,4,12,Champions
34,1,169.48000000000002,3,1,1,5,At Risk
239,2,510.72,1,2,3,6,At Risk
34,9,2655.95,3,4,4,11,Champions
169,1,576.5,1,1,3,5,At Risk
84,3,736.5600000000001,2,3,3,8,Potential Loyalist
102,4,685.6,2,3,3,8,Potential Loyalist
21,4,1273.89,3,3,4,10,Loyal Customers
18,9,2897.32,3,4,4,11,Champions
43,3,757.8,3,3,3,9,Loyal Customers
175,3,793.26,1,3,3,7,Potential Loyalist
34,5,1630.66,3,4,4,11,Champions
41,4,916.9200000000001,3,3,3,9,Loyal Customers
13,4,728.26,4,3,3,10,Loyal Customers
67,5,1505.34,2,4,4,10,Loyal Customers
72,2,302.64,2,2,2,6,At Risk
365,1,77.45,1,1,1,3,Lost
318,1,96.2,1,1,1,3,Lost
35,11,1996.75,3,4,4,11,Champions
22,2,745.14,3,2,3,8,Potential Loyalist
175,1,213.70000000000002,1,1,2,4,Lost
226,2,219.25,1,2,2,5,At Risk
30,9,2097.71,3,4,4,11,Champions
211,2,1516.7,1,2,4,7,Potential Loyalist
102,3,1293.0,2,3,4,9,Loyal Customers
270,1,104.12,1,1,1,3,Lost
310,1,98.58,1,1,1,3,Lost
81,1,1147.91,2,1,4,7,Potential Loyalist
2,4,1605.54,4,3,4,11,Champions
252,2,738.0600000000001,1,2,3,6,At Risk
56,5,2451.6,2,4,4,10,Loyal Customers
1,9,2439.26,4,4,4,12,Champions
133,1,104.1,2,1,1,4,Lost
70,1,633.79,2,1,3,6,At Risk
9,7,2032.41,4,4,4,12,Champions
146,2,177.17000000000002,1,2,1,4,Lost
101,2,333.43,2,2,2,6,At Risk
154,3,940.44,1,3,3,7,Potential Loyalist
323,1,341.65000000000003,1,1,2,4,Lost
217,1,92.42,1,1,1,3,Lost
65,2,330.2,2,2,2,6,At Risk
43,4,559.97,3,3,3,9,Loyal Customers
90,3,1042.49,2,3,3,8,Potential Loyalist
7,3,2858.52,4,3,4,11,Champions
188,1,92.63999999999999,1,1,1,3,Lost
11,13,2405.28,4,4,4,12,Champions
22,2,505.3,3,2,3,8,Potential Loyalist
13,4,368.78000000000003,4,3,2,9,Loyal Customers
15,3,3926.34,4,3,4,11,Champions
190,1,66.0,1,1,1,3,Lost
205,1,306.0,1,1,2,4,Lost
126,5,495.58000000000004,2,4,3,9,Loyal Customers
3,5,1983.2,4,4,4,12,Champions
49,9,2728.21,3,4,4,11,Champions
31,7,1574.6100000000001,3,4,4,11,Champions
139,3,644.01,2,3,3,8,Potential Loyalist
32,1,166.20000000000002,3,1,1,5,At Risk
9,4,1102.85,4,3,3,10,Loyal Customers
22,39,24125.83,3,4,4,11,Champions
13,7,1989.89,4,4,4,12,Champions
10,1,43.2,4,1,1,6,At Risk
109,1,128.7,2,1,1,4,Lost
214,1,224.4,1,1,2,4,Lost
63,3,1811.16,2,3,4,9,Loyal Customers
43,2,697.88,3,2,3,8,Potential Loyalist
80,6,2682.61,2,4,4,10,Loyal Customers
20,8,1496.43,3,4,4,11,Champions
234,1,198.97,1,1,1,3,Lost
38,6,1265.06,3,4,4,11,Champions
98,1,93.47999999999999,2,1,1,4,Lost
36,6,2014.03,3,4,4,11,Champions
56,1,375.58,2,1,2,5,At Risk
198,2,457.89,1,2,3,6,At Risk
2,5,1178.4,4,4,4,12,Champions
106,2,517.66,2,2,3,7,Potential Loyalist
234,1,123.85000000000001,1,1,1,3,Lost
155,1,311.65,1,1,2,4,Lost
9,7,4013.63,4,4,4,12,Champions
116,2,395.76,2,2,2,6,At Risk
14,3,585.15,4,3,3,10,Loyal Customers
59,1,188.20000000000002,2,1,1,4,Lost
8,8,1829.61,4,4,4,12,Champions
8,2,422.6,4,2,2,8,Potential Loyalist
8,4,1281.1100000000001,4,3,4,11,Champions
188,1,443.2,1,1,2,4,Lost
234,1,309.52,1,1,2,4,Lost
210,1,134.7,1,1,1,3,Lost
37,8,1873.77,3,4,4,11,Champions
13,4,322.8,4,3,2,9,Loyal Customers
119,8,615.5300000000001,2,4,3,9,Loyal Customers
30,1,108.97999999999999,3,1,1,5,At Risk
112,2,799.46,2,2,3,7,Potential Loyalist
252,1,297.87,1,1,2,4,Lost
2,1,125.0,4,1,1,6,At Risk
266,1,282.93,1,1,2,4,Lost
156,1,51.0,1,1,1,3,Lost
149,4,821.76,1,3,3,7,Potential Loyalist
207,1,90.6,1,1,1,3,Lost
22,1,87.78,3,1,1,5,At Risk
357,1,158.5,1,1,1,3,Lost
71,2,480.93,2,2,3,7,Potential Loyalist
35,1,215.82,3,1,2,6,At Risk
11,3,799.08,4,3,3,10,Loyal Customers
23,4,1732.83,3,3,4,10,Loyal Customers
14,1,148.45,4,1,1,6,At Risk
100,8,1022.95,2,4,3,9,Loyal Customers
13,15,6821.41,4,4,4,12,Champions
311,1,105.2,1,1,1,3,Lost
287,1,100.5,1,1,1,3,Lost
350,1,10.2,1,1,1,3,Lost
177,1,241.78,1,1,2,4,Lost
183,2,155.25,1,2,1,4,Lost
36,2,340.15000000000003,3,2,2,7,Potential Loyalist
44,1,202.68,3,1,1,5,At Risk
18,1,459.15999999999997,3,1,3,7,Potential Loyalist
30,3,903.67,3,3,3,9,Loyal Customers
1,3,202.11,4,3,1,8,Potential Loyalist
288,1,93.6,1,1,1,3,Lost
24,3,1501.21,3,3,4,10,Loyal Customers
2,8,2804.56,4,4,4,12,Champions
57,2,792.94,2,2,3,7,Potential Loyalist
2,9,3426.17,4,4,4,12,Champions
209,1,67.95,1,1,1,3,Lost
52,8,2704.9700000000003,2,4,4,10,Loyal Customers
57,2,451.09,2,2,2,6,At Risk
3,14,826.86,4,4,3,11,Champions
141,1,326.48,2,1,2,5,At Risk
30,12,2434.68,3,4,4,11,Champions
209,2,283.95000000000005,1,2,2,5,At Risk
25,6,1103.73,3,4,3,10,Loyal Customers
111,1,106.25,2,1,1,4,Lost
99,5,981.53,2,4,3,9,Loyal Customers
2,7,1823.53,4,4,4,12,Champions
62,4,875.4200000000001,2,3,3,8,Potential Loyalist
84,9,892.52,2,4,3,9,Loyal Customers
302,1,539.4000000000001,1,1,3,5,At Risk
34,2,562.33,3,2,3,8,Potential Loyalist
354,1,112.75,1,1,1,3,Lost
83,7,1033.42,2,4,3,9,Loyal Customers
11,12,4287.49,4,4,4,12,Champions
14,2,189.5,4,2,1,7,Potential Loyalist
17,2,746.99,4,2,3,9,Loyal Customers
2,6,1032.21,4,4,3,11,Champions
90,1,387.52,2,1,2,5,At Risk
49,2,728.61,3,2,3,8,Potential Loyalist
9,5,3114.68,4,4,4,12,Champions
210,1,20.4,1,1,1,3,Lost
15,9,2998.21,4,4,4,12,Champions
42,2,287.74,3,2,2,7,Potential Loyalist
28,4,661.4,3,3,3,9,Loyal Customers
294,1,303.66,1,1,2,4,Lost
1,6,2032.92,4,4,4,12,Champions
13,6,964.8000000000001,4,4,3,11,Champions
90,1,76.56,2,1,1,4,Lost
357,1,63.0,1,1,1,3,Lost
298,1,131.9,1,1,1,3,Lost
311,1,1637.3,1,1,4,6,At Risk
34,4,1183.43,3,3,4,10,Loyal Customers
35,3,1092.79,3,3,3,9,Loyal Customers
196,2,677.47,1,2,3,6,At Risk
45,4,1370.33,3,3,4,10,Loyal Customers
20,3,731.36,3,3,3,9,Loyal Customers
10,5,1147.33,4,4,4,12,Champions
1,2,127.80000000000001,4,2,1,7,Potential Loyalist
10,4,873.85,4,3,3,10,Loyal Customers
172,3,483.25,1,3,3,7,Potential Loyalist
52,2,645.59,2,2,3,7,Potential Loyalist
2,2,196.89000000000001,4,2,1,7,Potential Loyalist
182,1,109.98,1,1,1,3,Lost
14,8,2362.91,4,4,4,12,Champions
302,1,68.64,1,1,1,3,Lost
147,1,1274.16,1,1,4,6,At Risk
102,3,150.0,2,3,1,6,At Risk
140,3,1468.31,2,3,4,9,Loyal Customers
58,11,1652.38,2,4,4,10,Loyal Customers
197,1,39.599999999999994,1,1,1,3,Lost
238,3,506.77000000000004,1,3,3,7,Potential Loyalist
21,7,1400.65,3,4,4,11,Champions
9,4,532.51,4,3,3,10,Loyal Customers
3,2,303.99,4,2,2,8,Potential Loyalist
95,8,1556.62,2,4,4,10,Loyal Customers
66,1,95.28,2,1,1,4,Lost
38,1,240.06,3,1,2,6,At Risk
63,3,683.01,2,3,3,8,Potential Loyalist
249,1,205.75,1,1,1,3,Lost
42,1,83.2,3,1,1,5,At Risk
245,2,252.65,1,2,2,5,At Risk
3,1,262.55,4,1,2,7,Potential Loyalist
156,2,538.41,1,2,3,6,At Risk
10,6,1078.67,4,4,3,11,Champions
273,1,137.1,1,1,1,3,Lost
42,1,301.76,3,1,2,6,At Risk
30,1,147.3,3,1,1,5,At Risk
18,6,977.18,3,4,3,10,Loyal Customers
59,1,706.18,2,1,3,6,At Risk
199,1,433.5,1,1,2,4,Lost
167,2,220.98,1,2,2,5,At Risk
8,4,1600.94,4,3,4,11,Champions
17,1,139.56,4,1,1,6,At Risk
42,2,123.8,3,2,1,6,At Risk
303,2,291.92,1,2,2,5,At Risk
301,1,335.52,1,1,2,4,Lost
34,5,1519.27,3,4,4,11,Champions
18,3,775.62,3,3,3,9,Loyal Customers
80,2,218.10000000000002,2,2,2,6,At Risk
175,2,251.21,1,2,2,5,At Risk
11,9,1941.82,4,4,4,12,Champions
2,4,2131.79,4,3,4,11,Champions
39,4,522.21,3,3,3,9,Loyal Customers
9,8,4977.96,4,4,4,12,Champions
9,5,1258.3700000000001,4,4,4,12,Champions
32,5,944.08,3,4,3,10,Loyal Customers
13,2,196.42000000000002,4,2,1,7,Potential Loyalist
3,5,1173.41,4,4,4,12,Champions
179,2,175.63,1,2,1,4,Lost
198,2,183.75,1,2,1,4,Lost
53,3,787.5,2,3,3,8,Potential Loyalist
9,6,1567.71,4,4,4,12,Champions
25,2,192.55,3,2,1,6,At Risk
56,1,112.44,2,1,1,4,Lost
63,3,405.26,2,3,2,7,Potential Loyalist
100,1,160.91,2,1,1,4,Lost
23,9,1454.68,3,4,4,11,Champions
11,9,2352.16,4,4,4,12,Champions
4,52,3998.86,4,4,4,12,Champions
29,1,234.83999999999997,3,1,2,6,At Risk
52,3,584.39,2,3,3,8,Potential Loyalist
17,6,2017.8500000000001,4,4,4,12,Champions
228,3,200.4,1,3,1,5,At Risk
16,6,757.44,4,4,3,11,Champions
9,17,3125.46,4,4,4,12,Champions
52,3,2502.03,2,3,4,9,Loyal Customers
251,1,76.85000000000001,1,1,1,3,Lost
49,1,355.56,3,1,2,6,At Risk
56,2,334.35,2,2,2,6,At Risk
7,2,500.32,4,2,3,9,Loyal Customers
1,3,880.11,4,3,3,10,Loyal Customers
50,8,1380.35,2,4,4,10,Loyal Customers
177,1,103.25,1,1,1,3,Lost
20,16,1136.39,3,4,4,11,Champions
16,2,1195.72,4,2,4,10,Loyal Customers
32,4,1923.7,3,3,4,10,Loyal Customers
4,6,2890.8,4,4,4,12,Champions
303,1,224.98000000000002,1,1,2,4,Lost
2,2,659.02,4,2,3,9,Loyal Customers
10,2,148.23,4,2,1,7,Potential Loyalist
143,1,157.12,2,1,1,4,Lost
11,5,543.62,4,4,3,11,Champions
2,4,1946.83,4,3,4,11,Champions
49,2,263.3,3,2,2,7,Potential Loyalist
77,1,287.44,2,1,2,5,At Risk
8,13,600.03,4,4,3,11,Champions
67,3,957.37,2,3,3,8,Potential Loyalist
3,16,3749.7000000000003,4,4,4,12,Champions
87,4,2636.81,2,3,4,9,Loyal Customers
48,2,1257.96,3,2,4,9,Loyal Customers
272,2,190.21,1,2,1,4,Lost
32,6,2319.91,3,4,4,11,Champions
171,9,792.3000000000001,1,4,3,8,Potential Loyalist
363,1,35.400000000000006,1,1,1,3,Lost
4,4,859.71,4,3,3,10,Loyal Customers
8,1,95.67,4,1,1,6,At Risk
32,1,94.21000000000001,3,1,1,5,At Risk
136,4,624.53,2,3,3,8,Potential Loyalist
160,4,834.96,1,3,3,7,Potential Loyalist
42,1,148.55,3,1,1,5,At Risk
268,1,202.44,1,1,1,3,Lost
10,9,1279.18,4,4,4,12,Champions
7,4,971.14,4,3,3,10,Loyal Customers
27,3,528.81,3,3,3,9,Loyal Customers
13,3,451.79,4,3,2,9,Loyal Customers
365,1,214.15,1,1,2,4,Lost
11,6,1524.96,4,4,4,12,Champions
3,1,312.65,4,1,2,7,Potential Loyalist
36,1,221.97,3,1,2,6,At Risk
297,1,236.43,1,1,2,4,Lost
2,1,123.96000000000001,4,1,1,6,At Risk
1,88,8000.25,4,4,4,12,Champions
10,3,450.9,4,3,2,9,Loyal Customers
20,2,689.6,3,2,3,8,Potential Loyalist
276,1,10.08,1,1,1,3,Lost
1,3,408.84000000000003,4,3,2,9,Loyal Customers
237,1,263.74,1,1,2,4,Lost
197,2,318.54,1,2,2,5,At Risk
22,4,1242.4,3,3,4,10,Loyal Customers
176,1,288.78000000000003,1,1,2,4,Lost
24,5,690.85,3,4,3,10,Loyal Customers
49,2,225.85,3,2,2,7,Potential Loyalist
188,2,668.48,1,2,3,6,At Risk
15,4,2035.8200000000002,4,3,4,11,Champions
83,2,411.71000000000004,2,2,2,6,At Risk
39,1,331.88,3,1,2,6,At Risk
42,3,722.9200000000001,3,3,3,9,Loyal Customers
254,1,79.94,1,1,1,3,Lost
258,1,235.4,1,1,2,4,Lost
28,2,609.85,3,2,3,8,Potential Loyalist
42,1,269.6,3,1,2,6,At Risk
44,6,2119.57,3,4,4,11,Champions
16,6,1669.46,4,4,4,12,Champions
13,1,110.46,4,1,1,6,At Risk
50,1,19.8,2,1,1,4,Lost
162,2,295.87,1,2,2,5,At Risk
59,2,381.02000000000004,2,2,2,6,At Risk
148,2,419.42,1,2,2,5,At Risk
8,44,11046.36,4,4,4,12,Champions
193,1,243.22,1,1,2,4,Lost
64,3,573.44,2,3,3,8,Potential Loyalist
59,2,561.15,2,2,3,7,Potential Loyalist
69,1,94.28,2,1,1,4,Lost
1,6,1152.52,4,4,4,12,Champions
14,3,721.97,4,3,3,10,Loyal Customers
161,2,240.95000000000002,1,2,2,5,At Risk
9,4,707.37,4,3,3,10,Loyal Customers
109,1,47.39,2,1,1,4,Lost
27,8,2153.38,3,4,4,11,Champions
78,2,256.24,2,2,2,6,At Risk
18,1,41.05,3,1,1,5,At Risk
20,4,641.6,3,3,3,9,Loyal Customers
11,2,568.24,4,2,3,9,Loyal Customers
52,4,1490.75,2,3,4,9,Loyal Customers
16,1,175.35,4,1,1,6,At Risk
2,25,5982.09,4,4,4,12,Champions
233,3,1080.52,1,3,3,7,Potential Loyalist
272,2,403.58,1,2,2,5,At Risk
226,2,578.57,1,2,3,6,At Risk
1,4,1051.99,4,3,3,10,Loyal Customers
8,1,436.4,4,1,2,7,Potential Loyalist
23,5,702.12,3,4,3,10,Loyal Customers
17,15,3943.2,4,4,4,12,Champions
63,3,120.0,2,3,1,6,At Risk
17,5,1176.73,4,4,4,12,Champions
98,1,217.01999999999998,2,1,2,5,At Risk
31,19,3465.67,3,4,4,11,Champions
200,1,104.85,1,1,1,3,Lost
36,2,316.05,3,2,2,7,Potential Loyalist
22,5,1861.94,3,4,4,11,Champions
129,4,558.55,2,3,3,8,Potential Loyalist
256,1,45.4,1,1,1,3,Lost
63,6,1474.05,2,4,4,10,Loyal Customers
210,2,96.56,1,2,1,4,Lost
7,4,929.65,4,3,3,10,Loyal Customers
206,1,109.13000000000001,1,1,1,3,Lost
24,3,1384.53,3,3,4,10,Loyal Customers
2,9,1725.8700000000001,4,4,4,12,Champions
10,15,2139.06,4,4,4,12,Champions
6,1,318.17,4,1,2,7,Potential Loyalist
11,7,1343.73,4,4,4,12,Champions
360,1,241.02,1,1,2,4,Lost
7,13,4341.82,4,4,4,12,Champions
6,4,548.28,4,3,3,10,Loyal Customers
2,11,1807.35,4,4,4,12,Champions
21,3,851.73,3,3,3,9,Loyal Customers
1,11,2151.31,4,4,4,12,Champions
16,1,46.9,4,1,1,6,At Risk
16,4,687.23,4,3,3,10,Loyal Customers
35,2,215.5,3,2,2,7,Potential Loyalist
2,4,1074.71,4,3,3,10,Loyal Customers
81,2,296.03000000000003,2,2,2,6,At Risk
139,1,162.07,2,1,1,4,Lost
2,6,1028.28,4,4,3,11,Champions
16,1,450.83,4,1,2,7,Potential Loyalist
266,1,116.03,1,1,1,3,Lost
365,1,290.79,1,1,2,4,Lost
57,7,1392.13,2,4,4,10,Loyal Customers
39,3,346.13,3,3,2,8,Potential Loyalist
22,7,1747.08,3,4,4,11,Champions
8,12,4398.04,4,4,4,12,Champions
3,29,3798.1800000000003,4,4,4,12,Champions
120,2,510.55,2,2,3,7,Potential Loyalist
34,7,1154.7,3,4,4,11,Champions
11,6,745.38,4,4,3,11,Champions
188,3,1283.86,1,3,4,8,Potential Loyalist
3,6,1270.34,4,4,4,12,Champions
8,6,416.48,4,4,2,10,Loyal Customers
104,5,1085.5,2,4,3,9,Loyal Customers
241,1,176.95000000000002,1,1,1,3,Lost
20,5,1330.09,3,4,4,11,Champions
35,1,129.0,3,1,1,5,At Risk
79,1,526.75,2,1,3,6,At Risk
36,2,608.3,3,2,3,8,Potential Loyalist
1,11,4106.17,4,4,4,12,Champions
6,1,577.36,4,1,3,8,Potential Loyalist
67,1,395.5,2,1,2,5,At Risk
136,4,711.82,2,3,3,8,Potential Loyalist
104,2,489.8,2,2,3,7,Potential Loyalist
289,1,89.2,1,1,1,3,Lost
50,2,255.9,2,2,2,6,At Risk
255,1,277.12,1,1,2,4,Lost
38,1,79.8,3,1,1,5,At Risk
20,3,159.76,3,3,1,7,Potential Loyalist
72,5,1897.7,2,4,4,10,Loyal Customers
9,2,192.60000000000002,4,2,1,7,Potential Loyalist
74,7,8146.6,2,4,4,10,Loyal Customers
224,2,622.37,1,2,3,6,At Risk
104,1,126.50999999999999,2,1,1,4,Lost
50,3,879.42,2,3,3,8,Potential Loyalist
43,11,1239.54,3,4,4,11,Champions
119,2,691.0600000000001,2,2,3,7,Potential Loyalist
272,3,187.55,1,3,1,5,At Risk
46,2,400.88,3,2,2,7,Potential Loyalist
311,1,110.10000000000001,1,1,1,3,Lost
18,2,231.32000000000002,3,2,2,7,Potential Loyalist
7,1,39.480000000000004,4,1,1,6,At Risk
18,1,296.75,3,1,2,6,At Risk
20,1,169.2,3,1,1,5,At Risk
8,4,554.46,4,3,3,10,Loyal Customers
55,1,6.2,2,1,1,4,Lost
13,1,228.99,4,1,2,7,Potential Loyalist
1,5,855.2,4,4,3,11,Champions
158,1,4.25,1,1,1,3,Lost
14,16,6725.2,4,4,4,12,Champions
44,3,173.74,3,3,1,7,Potential Loyalist
43,1,32.720000000000006,3,1,1,5,At Risk
39,12,3563.22,3,4,4,11,Champions
53,1,184.64,2,1,1,4,Lost
154,3,279.45,1,3,2,6,At Risk
7,4,296.45,4,3,2,9,Loyal Customers
67,1,66.0,2,1,1,4,Lost
31,7,1374.47,3,4,4,11,Champions
32,11,2038.08,3,4,4,11,Champions
361,2,113.48,1,2,1,4,Lost
28,2,737.22,3,2,3,8,Potential Loyalist
189,1,11.9,1,1,1,3,Lost
192,2,962.08,1,2,3,6,At Risk
65,3,390.05,2,3,2,7,Potential Loyalist
56,2,176.07,2,2,1,5,At Risk
13,4,423.79,4,3,2,9,Loyal Customers
358,1,48.800000000000004,1,1,1,3,Lost
172,3,217.18,1,3,2,6,At Risk
2,4,711.71,4,3,3,10,Loyal Customers
7,11,1896.8700000000001,4,4,4,12,Champions
246,1,10.08,1,1,1,3,Lost
21,4,650.83,3,3,3,9,Loyal Customers
45,1,188.88,3,1,1,5,At Risk
9,6,1249.42,4,4,4,12,Champions
2,3,102.44999999999999,4,3,1,8,Potential Loyalist
81,4,1613.5,2,3,4,9,Loyal Customers
259,1,62.85,1,1,1,3,Lost
45,6,2687.08,3,4,4,11,Champions
35,4,2250.64,3,3,4,10,Loyal Customers
55,4,1986.51,2,3,4,9,Loyal Customers
140,1,218.4,2,1,2,5,At Risk
13,25,6635.39,4,4,4,12,Champions
303,1,317.25,1,1,2,4,Lost
15,2,416.55,4,2,2,8,Potential Loyalist
50,6,2228.7400000000002,2,4,4,10,Loyal Customers
16,2,88.5,4,2,1,7,Potential Loyalist
70,7,1841.38,2,4,4,10,Loyal Customers
126,1,91.85,2,1,1,4,Lost
28,3,919.9399999999999,3,3,3,9,Loyal Customers
51,2,931.17,2,2,3,7,Potential Loyalist
4,4,1190.54,4,3,4,11,Champions
11,1,149.44,4,1,1,6,At Risk
44,1,83.37,3,1,1,5,At Risk
17,2,727.62,4,2,3,9,Loyal Customers
21,1,266.76,3,1,2,6,At Risk
363,1,28.08,1,1,1,3,Lost
2,4,316.72,4,3,2,9,Loyal Customers
177,3,517.78,1,3,3,7,Potential Loyalist
13,7,2239.15,4,4,4,12,Champions
95,1,328.07,2,1,2,5,At Risk
253,1,327.25,1,1,2,4,Lost
170,3,354.75,1,3,2,6,At Risk
202,1,346.93,1,1,2,4,Lost
99,2,788.1500000000001,2,2,3,7,Potential Loyalist
4,9,1268.84,4,4,4,12,Champions
69,3,540.69,2,3,3,8,Potential Loyalist
11,1,221.2,4,1,2,7,Potential Loyalist
18,2,510.20000000000005,3,2,3,8,Potential Loyalist
10,6,727.75,4,4,3,11,Champions
123,1,102.0,2,1,1,4,Lost
244,1,325.0,1,1,2,4,Lost
199,1,369.2,1,1,2,4,Lost
328,1,135.9,1,1,1,3,Lost
245,1,125.65,1,1,1,3,Lost
139,2,468.1,2,2,3,7,Potential Loyalist
1,2,1044.63,4,2,3,9,Loyal Customers
77,1,614.95,2,1,3,6,At Risk
21,16,7479.67,3,4,4,11,Champions
196,2,457.82,1,2,3,6,At Risk
44,3,486.41999999999996,3,3,3,9,Loyal Customers
15,6,915.23,4,4,3,11,Champions
3,8,1040.31,4,4,3,11,Champions
17,1,299.66,4,1,2,7,Potential Loyalist
13,5,2401.73,4,4,4,12,Champions
17,1,209.1,4,1,2,7,Potential Loyalist
149,2,371.35,1,2,2,5,At Risk
20,6,2536.14,3,4,4,11,Champions
66,1,135.3,2,1,1,4,Lost
17,3,283.75,4,3,2,9,Loyal Customers
1,184,79874.25,4,4,4,12,Champions
8,2,323.77,4,2,2,8,Potential Loyalist
27,4,995.12,3,3,3,9,Loyal Customers
83,2,281.98,2,2,2,6,At Risk
62,4,1165.71,2,3,4,9,Loyal Customers
107,2,1308.89,2,2,4,8,Potential Loyalist
204,2,780.25,1,2,3,6,At Risk
22,2,1255.23,3,2,4,9,Loyal Customers
42,1,629.6,3,1,3,7,Potential Loyalist
237,1,168.05,1,1,1,3,Lost
24,1,172.88,3,1,1,5,At Risk
100,3,1513.51,2,3,4,9,Loyal Customers
14,3,626.48,4,3,3,10,Loyal Customers
357,1,140.43,1,1,1,3,Lost
73,2,1246.59,2,2,4,8,Potential Loyalist
25,7,5469.07,3,4,4,11,Champions
48,2,1158.68,3,2,4,9,Loyal Customers
21,12,4288.900000000001,3,4,4,11,Champions
6,1,100.9,4,1,1,6,At Risk
64,2,275.82,2,2,2,6,At Risk
15,6,927.11,4,4,3,11,Champions
11,1,243.5,4,1,2,7,Potential Loyalist
71,1,259.52,2,1,2,5,At Risk
51,9,4315.92,2,4,4,10,Loyal Customers
17,1,206.74,4,1,2,7,Potential Loyalist
4,1,194.82,4,1,1,6,At Risk
244,1,58.49,1,1,1,3,Lost
139,3,213.88,2,3,2,7,Potential Loyalist
55,4,609.54,2,3,3,8,Potential Loyalist
163,1,88.3,1,1,1,3,Lost
2,9,6021.2300000000005,4,4,4,12,Champions
262,1,14.850000000000001,1,1,1,3,Lost
1,5,999.09,4,4,3,11,Champions
239,1,81.75,1,1,1,3,Lost
88,1,464.55,2,1,3,6,At Risk
6,1,176.2,4,1,1,6,At Risk
41,1,139.8,3,1,1,5,At Risk
22,1,139.09,3,1,1,5,At Risk
60,4,1465.51,2,3,4,9,Loyal Customers
27,3,827.29,3,3,3,9,Loyal Customers
120,1,53.47,2,1,1,4,Lost
99,3,465.4,2,3,3,8,Potential Loyalist
29,1,94.49000000000001,3,1,1,5,At Risk
49,1,38.65,3,1,1,5,At Risk
49,6,625.0600000000001,3,4,3,10,Loyal Customers
64,5,1081.3700000000001,2,4,3,9,Loyal Customers
238,1,102.12,1,1,1,3,Lost
11,2,92.52,4,2,1,7,Potential Loyalist
190,2,268.08,1,2,2,5,At Risk
203,1,305.29,1,1,2,4,Lost
30,2,204.68,3,2,1,6,At Risk
38,3,234.32,3,3,2,8,Potential Loyalist
162,2,356.87,1,2,2,5,At Risk
39,1,443.42,3,1,2,6,At Risk
107,4,1525.66,2,3,4,9,Loyal Customers
139,1,849.15,2,1,3,6,At Risk
7,28,5630.26,4,4,4,12,Champions
43,1,456.69,3,1,3,7,Potential Loyalist
151,1,146.96,1,1,1,3,Lost
4,3,1161.63,4,3,4,11,Champions
27,1,263.19,3,1,2,6,At Risk
45,2,361.19,3,2,2,7,Potential Loyalist
34,2,177.67000000000002,3,2,1,6,At Risk
164,1,100.24000000000001,1,1,1,3,Lost
25,1,115.63,3,1,1,5,At Risk
30,3,275.36,3,3,2,8,Potential Loyalist
258,1,239.05,1,1,2,4,Lost
18,8,1384.4,3,4,4,11,Champions
3,3,790.32,4,3,3,10,Loyal Customers
31,10,3967.4500000000003,3,4,4,11,Champions
1,9,1495.23,4,4,4,12,Champions
25,1,357.11,3,1,2,6,At Risk
72,3,343.75,2,3,2,7,Potential Loyalist
22,4,516.35,3,3,3,9,Loyal Customers
34,3,455.64,3,3,3,9,Loyal Customers
260,1,20.4,1,1,1,3,Lost
21,3,345.41,3,3,2,8,Potential Loyalist
248,2,315.25,1,2,2,5,At Risk
17,9,2148.84,4,4,4,12,Champions
7,8,3042.46,4,4,4,12,Champions
81,1,227.29000000000002,2,1,2,5,At Risk
64,3,377.09999999999997,2,3,2,7,Potential Loyalist
50,6,403.29,2,4,2,8,Potential Loyalist
1,45,14094.52,4,4,4,12,Champions
162,1,151.9,1,1,1,3,Lost
191,1,46.68,1,1,1,3,Lost
11,17,5489.900000000001,4,4,4,12,Champions
143,1,60.06,2,1,1,4,Lost
1,15,2396.03,4,4,4,12,Champions
261,1,329.7,1,1,2,4,Lost
57,4,284.35,2,3,2,7,Potential Loyalist
265,1,40.050000000000004,1,1,1,3,Lost
17,3,1026.69,4,3,3,10,Loyal Customers
15,3,1186.13,4,3,4,11,Champions
311,1,135.88,1,1,1,3,Lost
148,2,399.03999999999996,1,2,2,5,At Risk
4,2,277.95,4,2,2,8,Potential Loyalist
267,2,807.0,1,2,3,6,At Risk
17,11,1859.34,4,4,4,12,Champions
32,9,1057.8700000000001,3,4,3,10,Loyal Customers
1,3,260.98,4,3,2,9,Loyal Customers
2,32,6389.2699999999995,4,4,4,12,Champions
63,4,912.38,2,3,3,8,Potential Loyalist
205,1,70.19999999999999,1,1,1,3,Lost
29,4,2234.06,3,3,4,10,Loyal Customers
45,1,701.79,3,1,3,7,Potential Loyalist
70,3,1277.2,2,3,4,9,Loyal Customers
38,2,453.45,3,2,3,8,Potential Loyalist
171,1,825.48,1,1,3,5,At Risk
85,2,601.82,2,2,3,7,Potential Loyalist
1,3,1043.41,4,3,3,10,Loyal Customers
97,1,748.87,2,1,3,6,At Risk
69,1,496.78,2,1,3,6,At Risk
164,1,771.3,1,1,3,5,At Risk
3,28,8535.58,4,4,4,12,Champions
204,3,610.5600000000001,1,3,3,7,Potential Loyalist
14,5,378.7,4,4,2,10,Loyal Customers
248,1,62.699999999999996,1,1,1,3,Lost
273,1,220.06,1,1,2,4,Lost
13,2,825.52,4,2,3,9,Loyal Customers
2,6,1906.6100000000001,4,4,4,12,Champions
300,1,263.12,1,1,2,4,Lost
59,1,446.71,2,1,2,5,At Risk
207,2,279.61,1,2,2,5,At Risk
10,6,1807.28,4,4,4,12,Champions
95,4,796.74,2,3,3,8,Potential Loyalist
34,1,206.89000000000001,3,1,2,6,At Risk
76,1,238.70000000000002,2,1,2,5,At Risk
351,1,102.28,1,1,1,3,Lost
23,2,573.46,3,2,3,8,Potential Loyalist
188,2,571.49,1,2,3,6,At Risk
10,7,1728.99,4,4,4,12,Champions
9,5,1235.45,4,4,4,12,Champions
322,4,104.10000000000001,1,3,1,5,At Risk
133,3,983.5500000000001,2,3,3,8,Potential Loyalist
237,1,327.15000000000003,1,1,2,4,Lost
15,4,620.4,4,3,3,10,Loyal Customers
21,3,1339.68,3,3,4,10,Loyal Customers
1,3,1690.09,4,3,4,11,Champions
22,10,2650.16,3,4,4,11,Champions
10,1,238.81,4,1,2,7,Potential Loyalist
9,4,1092.68,4,3,3,10,Loyal Customers
6,5,1146.73,4,4,4,12,Champions
237,1,162.8,1,1,1,3,Lost
125,1,244.4,2,1,2,5,At Risk
42,2,399.07,3,2,2,7,Potential Loyalist
106,3,1286.28,2,3,4,9,Loyal Customers
198,1,994.47,1,1,3,5,At Risk
14,2,126.5,4,2,1,7,Potential Loyalist
52,9,2362.7,2,4,4,10,Loyal Customers
57,1,346.53,2,1,2,5,At Risk
52,4,1307.74,2,3,4,9,Loyal Customers
42,10,1583.27,3,4,4,11,Champions
161,1,330.11,1,1,2,4,Lost
10,5,791.69,4,4,3,11,Champions
119,3,584.1800000000001,2,3,3,8,Potential Loyalist
6,8,1299.55,4,4,4,12,Champions
230,1,139.05,1,1,1,3,Lost
14,2,977.6,4,2,3,9,Loyal Customers
231,2,169.84,1,2,1,4,Lost
44,7,1604.01,3,4,4,11,Champions
38,1,430.52,3,1,2,6,At Risk
217,1,239.55,1,1,2,4,Lost
16,16,5556.22,4,4,4,12,Champions
35,3,763.37,3,3,3,9,Loyal Customers
156,2,1164.52,1,2,4,7,Potential Loyalist
232,1,382.0,1,1,2,4,Lost
2,1,301.29,4,1,2,7,Potential Loyalist
125,1,327.45000000000005,2,1,2,5,At Risk
9,10,4615.33,4,4,4,12,Champions
1,13,3794.9900000000002,4,4,4,12,Champions
23,1,251.82,3,1,2,6,At Risk
67,1,199.47,2,1,1,4,Lost
25,1,270.0,3,1,2,6,At Risk
146,2,978.03,1,2,3,6,At Risk
37,1,119.76,3,1,1,5,At Risk
10,25,12940.85,4,4,4,12,Champions
349,1,51.96,1,1,1,3,Lost
10,2,278.77,4,2,2,8,Potential Loyalist
60,3,777.55,2,3,3,8,Potential Loyalist
365,1,362.7,1,1,2,4,Lost
312,1,138.6,1,1,1,3,Lost
17,1,58.86,4,1,1,6,At Risk
62,4,1057.54,2,3,3,8,Potential Loyalist
314,1,120.63,1,1,1,3,Lost
63,1,212.5,2,1,2,5,At Risk
252,1,40.5,1,1,1,3,Lost
10,4,1533.79,4,3,4,11,Champions
359,1,87.5,1,1,1,3,Lost
58,3,194.99999999999997,2,3,1,6,At Risk
146,2,605.85,1,2,3,6,At Risk
21,2,288.01,3,2,2,7,Potential Loyalist
62,1,139.92000000000002,2,1,1,4,Lost
6,2,349.85,4,2,2,8,Potential Loyalist
7,9,1548.8799999999999,4,4,4,12,Champions
2,36,4881.68,4,4,4,12,Champions
111,3,618.6,2,3,3,8,Potential Loyalist
52,1,336.95,2,1,2,5,At Risk
23,14,4786.75,3,4,4,11,Champions
2,3,451.11,4,3,2,9,Loyal Customers
84,2,193.64,2,2,1,5,At Risk
51,4,418.70000000000005,2,3,2,7,Potential Loyalist
79,5,1116.54,2,4,4,10,Loyal Customers
17,6,1757.4,4,4,4,12,Champions
349,1,157.5,1,1,1,3,Lost
76,2,425.25,2,2,2,6,At Risk
2,4,420.29999999999995,4,3,2,9,Loyal Customers
23,4,362.42,3,3,2,8,Potential Loyalist
217,1,211.2,1,1,2,4,Lost
52,2,670.9100000000001,2,2,3,7,Potential Loyalist
233,1,62.0,1,1,1,3,Lost
310,2,328.35,1,2,2,5,At Risk
2,7,1368.38,4,4,4,12,Champions
38,3,494.24,3,3,3,9,Loyal Customers
79,1,33.0,2,1,1,4,Lost
2,10,3102.65,4,4,4,12,Champions
168,1,152.8,1,1,1,3,Lost
43,6,1560.45,3,4,4,11,Champions
358,1,162.60000000000002,1,1,1,3,Lost
217,2,444.55,1,2,2,5,At Risk
350,2,244.13,1,2,2,5,At Risk
226,1,344.70000000000005,1,1,2,4,Lost
302,1,128.91,1,1,1,3,Lost
28,5,891.78,3,4,3,10,Loyal Customers
58,4,2337.55,2,3,4,9,Loyal Customers
231,2,429.6,1,2,2,5,At Risk
105,2,358.06,2,2,2,6,At Risk
268,1,187.88,1,1,1,3,Lost
209,12,2015.51,1,4,4,9,Loyal Customers
290,1,321.05,1,1,2,4,Lost
70,3,1175.6200000000001,2,3,4,9,Loyal Customers
21,3,747.23,3,3,3,9,Loyal Customers
2,2,749.67,4,2,3,9,Loyal Customers
36,5,1168.8,3,4,4,11,Champions
58,8,1347.01,2,4,4,10,Loyal Customers
66,1,316.68,2,1,2,5,At Risk
57,2,565.17,2,2,3,7,Potential Loyalist
125,3,1490.76,2,3,4,9,Loyal Customers
230,2,458.1,1,2,3,6,At Risk
114,1,111.19999999999999,2,1,1,4,Lost
23,13,6298.46,3,4,4,11,Champions
83,7,1307.12,2,4,4,10,Loyal Customers
28,2,740.78,3,2,3,8,Potential Loyalist
8,5,847.29,4,4,3,11,Champions
119,1,253.32,2,1,2,5,At Risk
58,1,865.35,2,1,3,6,At Risk
140,1,98.45,2,1,1,4,Lost
275,1,40.2,1,1,1,3,Lost
160,2,386.76,1,2,2,5,At Risk
92,6,1595.27,2,4,4,10,Loyal Customers
127,1,254.82,2,1,2,5,At Risk
315,1,161.95000000000002,1,1,1,3,Lost
98,1,139.51,2,1,1,4,Lost
56,1,393.74,2,1,2,5,At Risk
143,2,1076.52,2,2,3,7,Potential Loyalist
330,1,47.7,1,1,1,3,Lost
15,1,118.80000000000001,4,1,1,6,At Risk
7,6,842.0500000000001,4,4,3,11,Champions
18,14,2004.69,3,4,4,11,Champions
49,2,502.26,3,2,3,8,Potential Loyalist
10,1,349.19,4,1,2,7,Potential Loyalist
29,1,473.29,3,1,3,7,Potential Loyalist
58,1,102.06,2,1,1,4,Lost
38,1,241.98,3,1,2,6,At Risk
346,1,240.45,1,1,2,4,Lost
164,1,87.62,1,1,1,3,Lost
50,9,1900.68,2,4,4,10,Loyal Customers
41,1,240.55,3,1,2,6,At Risk
14,2,414.69,4,2,2,8,Potential Loyalist
35,5,2074.12,3,4,4,11,Champions
21,3,689.46,3,3,3,9,Loyal Customers
23,15,3529.18,3,4,4,11,Champions
17,11,2234.16,4,4,4,12,Champions
193,1,114.24000000000001,1,1,1,3,Lost
42,6,2874.4700000000003,3,4,4,11,Champions
2,3,624.94,4,3,3,10,Loyal Customers
2,10,2945.26,4,4,4,12,Champions
56,1,454.44,2,1,3,6,At Risk
42,11,3498.94,3,4,4,11,Champions
282,1,444.42,1,1,2,4,Lost
52,5,242.60000000000002,2,4,2,8,Potential Loyalist
56,3,854.02,2,3,3,8,Potential Loyalist
87,1,119.20000000000002,2,1,1,4,Lost
266,1,218.25,1,1,2,4,Lost
2,88,17228.03,4,4,4,12,Champions
67,4,843.25,2,3,3,8,Potential Loyalist
102,1,52.0,2,1,1,4,Lost
191,1,314.05,1,1,2,4,Lost
56,2,475.21999999999997,2,2,3,7,Potential Loyalist
275,1,145.0,1,1,1,3,Lost
36,1,189.03,3,1,1,5,At Risk
62,3,2062.64,2,3,4,9,Loyal Customers
77,1,606.66,2,1,3,6,At Risk
95,1,162.29,2,1,1,4,Lost
325,1,311.71,1,1,2,4,Lost
44,1,125.1,3,1,1,5,At Risk
31,3,830.95,3,3,3,9,Loyal Customers
23,1,29.759999999999998,3,1,1,5,At Risk
361,3,1266.86,1,3,4,8,Potential Loyalist
200,1,238.0,1,1,2,4,Lost
148,3,341.72,1,3,2,6,At Risk
45,1,165.47,3,1,1,5,At Risk
58,2,528.71,2,2,3,7,Potential Loyalist
72,1,732.96,2,1,3,6,At Risk
121,1,391.14,2,1,2,5,At Risk
79,1,153.7,2,1,1,4,Lost
24,2,187.79000000000002,3,2,1,6,At Risk
37,1,230.39000000000001,3,1,2,6,At Risk
324,1,252.42000000000002,1,1,2,4,Lost
358,1,81.60000000000001,1,1,1,3,Lost
64,1,158.04,2,1,1,4,Lost
150,2,367.36,1,2,2,5,At Risk
365,1,115.65,1,1,1,3,Lost
4,7,1658.31,4,4,4,12,Champions
246,2,555.1700000000001,1,2,3,6,At Risk
21,2,189.3,3,2,1,6,At Risk
23,10,2728.95,3,4,4,11,Champions
27,20,6802.3,3,4,4,11,Champions
31,1,427.93,3,1,2,6,At Risk
353,1,139.8,1,1,1,3,Lost
364,1,310.1,1,1,2,4,Lost
87,2,675.59,2,2,3,7,Potential Loyalist
17,7,2115.7200000000003,4,4,4,12,Champions
67,2,529.94,2,2,3,7,Potential Loyalist
49,4,1690.8500000000001,3,3,4,10,Loyal Customers
63,5,1495.2,2,4,4,10,Loyal Customers
10,9,1198.48,4,4,4,12,Champions
120,1,25.200000000000003,2,1,1,4,Lost
32,3,1092.81,3,3,3,9,Loyal Customers
161,7,3192.81,1,4,4,9,Loyal Customers
38,3,178.54,3,3,1,7,Potential Loyalist
260,1,143.1,1,1,1,3,Lost
6,6,5136.82,4,4,4,12,Champions
161,2,591.91,1,2,3,6,At Risk
32,1,142.46,3,1,1,5,At Risk
178,1,370.74,1,1,2,4,Lost
262,1,140.54,1,1,1,3,Lost
22,3,1117.63,3,3,4,10,Loyal Customers
8,2,231.86,4,2,2,8,Potential Loyalist
1,4,1743.69,4,3,4,11,Champions
317,1,74.55000000000001,1,1,1,3,Lost
104,1,204.28,2,1,1,4,Lost
281,1,94.0,1,1,1,3,Lost
8,2,1283.63,4,2,4,10,Loyal Customers
14,2,502.33,4,2,3,9,Loyal Customers
120,3,208.6,2,3,2,7,Potential Loyalist
140,2,396.81,2,2,2,6,At Risk
181,1,128.84,1,1,1,3,Lost
23,2,331.79,3,2,2,7,Potential Loyalist
25,4,662.44,3,3,3,9,Loyal Customers
256,1,121.98,1,1,1,3,Lost
76,8,2612.19,2,4,4,10,Loyal Customers
18,4,1022.2,3,3,3,9,Loyal Customers
163,1,49.79,1,1,1,3,Lost
1,3,675.45,4,3,3,10,Loyal Customers
305,1,478.29,1,1,3,5,At Risk
56,4,2990.0,2,3,4,9,Loyal Customers
77,1,508.8,2,1,3,6,At Risk
16,1,84.74,4,1,1,6,At Risk
50,4,856.94,2,3,3,8,Potential Loyalist
315,2,97.7,1,2,1,4,Lost
30,1,7.5,3,1,1,5,At Risk
246,2,304.14,1,2,2,5,At Risk
11,5,1239.39,4,4,4,12,Champions
25,3,1306.95,3,3,4,10,Loyal Customers
7,1,75.06,4,1,1,6,At Risk
18,2,321.68,3,2,2,7,Potential Loyalist
15,1,171.19,4,1,1,6,At Risk
205,2,533.3,1,2,3,6,At Risk
23,4,682.96,3,3,3,9,Loyal Customers
14,1,109.94,4,1,1,6,At Risk
4,3,965.93,4,3,3,10,Loyal Customers
254,1,183.71,1,1,1,3,Lost
123,1,137.13,2,1,1,4,Lost
46,3,307.18,3,3,2,8,Potential Loyalist
4,6,2320.84,4,4,4,12,Champions
1,2,1260.86,4,2,4,10,Loyal Customers
256,1,68.1,1,1,1,3,Lost
322,1,129.67,1,1,1,3,Lost
304,1,405.04,1,1,2,4,Lost
18,3,903.26,3,3,3,9,Loyal Customers
22,1,388.94,3,1,2,6,At Risk
21,3,503.08,3,3,3,9,Loyal Customers
27,6,1057.89,3,4,3,10,Loyal Customers
354,1,157.2,1,1,1,3,Lost
275,3,368.8,1,3,2,6,At Risk
254,1,217.17,1,1,2,4,Lost
17,1,142.92,4,1,1,6,At Risk
346,1,169.66,1,1,1,3,Lost
86,3,144.6,2,3,1,6,At Risk
21,1,119.3,3,1,1,5,At Risk
330,1,717.45,1,1,3,5,At Risk
11,18,1854.59,4,4,4,12,Champions
77,1,324.58,2,1,2,5,At Risk
1,3,499.93,4,3,3,10,Loyal Customers
43,1,377.91,3,1,2,6,At Risk
42,2,282.1,3,2,2,7,Potential Loyalist
105,1,335.15999999999997,2,1,2,5,At Risk
69,1,406.31,2,1,2,5,At Risk
32,2,885.7900000000001,3,2,3,8,Potential Loyalist
108,1,579.25,2,1,3,6,At Risk
7,9,2176.88,4,4,4,12,Champions
153,4,201.31,1,3,1,5,At Risk
10,3,2040.4,4,3,4,11,Champions
22,3,1398.96,3,3,4,10,Loyal Customers
14,3,746.39,4,3,3,10,Loyal Customers
87,6,2358.59,2,4,4,10,Loyal Customers
20,2,504.73999999999995,3,2,3,8,Potential Loyalist
24,5,1225.2,3,4,4,11,Champions
13,2,1058.73,4,2,3,9,Loyal Customers
9,2,498.0,4,2,3,9,Loyal Customers
9,25,10364.35,4,4,4,12,Champions
10,3,654.63,4,3,3,10,Loyal Customers
7,9,3505.42,4,4,4,12,Champions
354,1,128.64000000000001,1,1,1,3,Lost
73,1,52.83,2,1,1,4,Lost
44,5,1903.86,3,4,4,11,Champions
14,3,745.39,4,3,3,10,Loyal Customers
163,1,296.76,1,1,2,4,Lost
181,6,771.13,1,4,3,8,Potential Loyalist
3,5,539.63,4,4,3,11,Champions
147,2,121.0,1,2,1,4,Lost
25,17,8215.22,3,4,4,11,Champions
4,10,2139.74,4,4,4,12,Champions
36,3,53.93,3,3,1,7,Potential Loyalist
225,1,246.72,1,1,2,4,Lost
56,7,1721.78,2,4,4,10,Loyal Customers
32,7,1946.36,3,4,4,11,Champions
24,2,327.5,3,2,2,7,Potential Loyalist
76,1,88.51,2,1,1,4,Lost
9,2,408.88,4,2,2,8,Potential Loyalist
25,1,9.14,3,1,1,5,At Risk
10,8,1482.64,4,4,4,12,Champions
246,1,153.43,1,1,1,3,Lost
14,11,3651.56,4,4,4,12,Champions
13,4,1072.96,4,3,3,10,Loyal Customers
21,1,1294.77,3,1,4,8,Potential Loyalist
17,4,1107.59,4,3,4,11,Champions
11,3,504.42,4,3,3,10,Loyal Customers
165,4,285.3,1,3,2,6,At Risk
155,1,86.02,1,1,1,3,Lost
3,1,185.22,4,1,1,6,At Risk
106,1,85.13000000000001,2,1,1,4,Lost
280,1,117.91,1,1,1,3,Lost
1,9,3479.21,4,4,4,12,Champions
46,2,233.12,3,2,2,7,Potential Loyalist
32,12,3499.46,3,4,4,11,Champions
69,3,1195.81,2,3,4,9,Loyal Customers
98,3,370.28,2,3,2,7,Potential Loyalist
28,1,270.87,3,1,2,6,At Risk
209,1,90.12,1,1,1,3,Lost
52,1,390.93,2,1,2,5,At Risk
269,1,130.4,1,1,1,3,Lost
4,16,4025.9,4,4,4,12,Champions
16,1,201.37,4,1,1,6,At Risk
20,1,281.0,3,1,2,6,At Risk
3,4,520.19,4,3,3,10,Loyal Customers
14,3,1120.83,4,3,4,11,Champions
42,2,123.66000000000001,3,2,1,6,At Risk
10,1,59.7,4,1,1,6,At Risk
36,2,388.62,3,2,2,7,Potential Loyalist
123,2,59.160000000000004,2,2,1,5,At Risk
2,11,3185.48,4,4,4,12,Champions
3,4,558.05,4,3,3,10,Loyal Customers
17,6,1671.1,4,4,4,12,Champions
23,2,430.56,3,2,2,7,Potential Loyalist
169,4,465.26,1,3,3,7,Potential Loyalist
29,1,595.63,3,1,3,7,Potential Loyalist
143,3,209.53,2,3,2,7,Potential Loyalist
154,1,119.15,1,1,1,3,Lost
60,2,214.1,2,2,2,6,At Risk
122,11,608.13,2,4,3,9,Loyal Customers
16,3,663.01,4,3,3,10,Loyal Customers
15,4,571.71,4,3,3,10,Loyal Customers
168,1,439.4,1,1,2,4,Lost
42,3,305.28,3,3,2,8,Potential Loyalist
247,3,413.73,1,3,2,6,At Risk
38,1,314.66,3,1,2,6,At Risk
62,1,199.8,2,1,1,4,Lost
7,5,1648.5,4,4,4,12,Champions
92,5,1109.14,2,4,4,10,Loyal Customers
27,1,324.57,3,1,2,6,At Risk
45,1,223.68,3,1,2,6,At Risk
18,2,653.6899999999999,3,2,3,8,Potential Loyalist
3,14,5198.57,4,4,4,12,Champions
13,6,599.78,4,4,3,11,Champions
44,1,216.39,3,1,2,6,At Risk
28,5,944.5300000000001,3,4,3,10,Loyal Customers
53,9,2570.92,2,4,4,10,Loyal Customers
328,1,87.76,1,1,1,3,Lost
52,3,800.16,2,3,3,8,Potential Loyalist
176,1,268.78000000000003,1,1,2,4,Lost
43,1,112.46000000000001,3,1,1,5,At Risk
1,11,682.71,4,4,3,11,Champions
28,2,180.15,3,2,1,6,At Risk
2,22,8027.4800000000005,4,4,4,12,Champions
24,4,739.951,3,3,3,9,Loyal Customers
2,1,99.60000000000001,4,1,1,6,At Risk
48,3,1207.95,3,3,4,10,Loyal Customers
3,1,78.96000000000001,4,1,1,6,At Risk
35,9,3050.79,3,4,4,11,Champions
133,1,229.43,2,1,2,5,At Risk
108,4,511.5,2,3,3,8,Potential Loyalist
95,4,1161.42,2,3,4,9,Loyal Customers
66,2,562.56,2,2,3,7,Potential Loyalist
16,8,2447.39,4,4,4,12,Champions
37,2,977.75,3,2,3,8,Potential Loyalist
7,8,2874.85,4,4,4,12,Champions
9,1,227.65,4,1,2,7,Potential Loyalist
81,2,589.5600000000001,2,2,3,7,Potential Loyalist
44,1,223.36,3,1,2,6,At Risk
126,1,178.02,2,1,1,4,Lost
8,13,7122.1900000000005,4,4,4,12,Champions
97,4,1749.32,2,3,4,9,Loyal Customers
183,3,433.95000000000005,1,3,2,6,At Risk
158,4,741.55,1,3,3,7,Potential Loyalist
10,1,481.51000000000005,4,1,3,8,Potential Loyalist
149,3,364.57000000000005,1,3,2,6,At Risk
196,2,483.05,1,2,3,6,At Risk
28,3,491.65999999999997,3,3,3,9,Loyal Customers
83,1,293.09000000000003,2,1,2,5,At Risk
107,1,48.0,2,1,1,4,Lost
1,2,380.91,4,2,2,8,Potential Loyalist
235,1,465.57,1,1,3,5,At Risk
37,4,569.4,3,3,3,9,Loyal Customers
14,1,30.0,4,1,1,6,At Risk
182,4,583.85,1,3,3,7,Potential Loyalist
35,1,77.85,3,1,1,5,At Risk
17,8,1470.24,4,4,4,12,Champions
309,1,19.8,1,1,1,3,Lost
98,1,124.1,2,1,1,4,Lost
42,1,311.43,3,1,2,6,At Risk
160,2,1907.25,1,2,4,7,Potential Loyalist
31,1,301.32,3,1,2,6,At Risk
32,4,437.0,3,3,2,8,Potential Loyalist
288,1,157.15,1,1,1,3,Lost
17,6,1179.81,4,4,4,12,Champions
80,4,2209.05,2,3,4,9,Loyal Customers
65,4,1823.6100000000001,2,3,4,9,Loyal Customers
73,3,216.16,2,3,2,7,Potential Loyalist
10,3,2787.22,4,3,4,11,Champions
41,1,580.93,3,1,3,7,Potential Loyalist
44,1,290.3,3,1,2,6,At Risk
16,4,690.98,4,3,3,10,Loyal Customers
1,3,1153.39,4,3,4,11,Champions
17,5,1358.16,4,4,4,12,Champions
109,1,152.95,2,1,1,4,Lost
15,8,2112.54,4,4,4,12,Champions
111,2,238.8,2,2,2,6,At Risk
92,1,91.44,2,1,1,4,Lost
20,1,191.04,3,1,1,5,At Risk
17,10,2275.96,4,4,4,12,Champions
258,2,357.81,1,2,2,5,At Risk
25,8,2253.31,3,4,4,11,Champions
9,1,201.0,4,1,1,6,At Risk
164,2,551.43,1,2,3,6,At Risk
60,3,920.36,2,3,3,8,Potential Loyalist
256,1,211.5,1,1,2,4,Lost
132,4,1778.3700000000001,2,3,4,9,Loyal Customers
193,1,19.5,1,1,1,3,Lost
56,3,714.16,2,3,3,8,Potential Loyalist
27,4,822.36,3,3,3,9,Loyal Customers
32,7,2712.9700000000003,3,4,4,11,Champions
275,1,69.65,1,1,1,3,Lost
1,5,842.9,4,4,3,11,Champions
135,2,266.6,2,2,2,6,At Risk
3,2,255.38000000000002,4,2,2,8,Potential Loyalist
137,4,842.34,2,3,3,8,Potential Loyalist
226,1,150.3,1,1,1,3,Lost
24,13,4647.16,3,4,4,11,Champions
16,1,423.03000000000003,4,1,2,7,Potential Loyalist
3,1,494.58,4,1,3,8,Potential Loyalist
27,4,858.7700000000001,3,3,3,9,Loyal Customers
356,1,149.4,1,1,1,3,Lost
193,2,218.25,1,2,2,5,At Risk
7,1,382.25,4,1,2,7,Potential Loyalist
8,7,3889.91,4,4,4,12,Champions
204,1,85.0,1,1,1,3,Lost
57,3,943.91,2,3,3,8,Potential Loyalist
204,2,280.2,1,2,2,5,At Risk
274,1,112.4,1,1,1,3,Lost
106,2,376.35,2,2,2,6,At Risk
6,7,948.85,4,4,3,11,Champions
10,16,3804.94,4,4,4,12,Champions
58,1,77.6,2,1,1,4,Lost
41,1,126.80000000000001,3,1,1,5,At Risk
8,4,566.3100000000001,4,3,3,10,Loyal Customers
69,1,6.959999999999999,2,1,1,4,Lost
11,4,928.5400000000001,4,3,3,10,Loyal Customers
126,1,182.96,2,1,1,4,Lost
4,3,658.49,4,3,3,10,Loyal Customers
32,1,139.36,3,1,1,5,At Risk
6,7,1884.91,4,4,4,12,Champions
31,7,2605.25,3,4,4,11,Champions
43,3,458.57,3,3,3,9,Loyal Customers
2,6,2059.84,4,4,4,12,Champions
53,4,459.36,2,3,3,8,Potential Loyalist
57,2,672.88,2,2,3,7,Potential Loyalist
16,1,205.25,4,1,1,6,At Risk
288,2,77.24000000000001,1,2,1,4,Lost
57,2,482.95000000000005,2,2,3,7,Potential Loyalist
23,2,602.87,3,2,3,8,Potential Loyalist
79,6,2602.27,2,4,4,10,Loyal Customers
56,1,273.65999999999997,2,1,2,5,At Risk
107,3,331.03,2,3,2,7,Potential Loyalist
227,1,122.03999999999999,1,1,1,3,Lost
60,1,189.75,2,1,1,4,Lost
237,1,87.9,1,1,1,3,Lost
125,1,164.13,2,1,1,4,Lost
233,3,309.21000000000004,1,3,2,6,At Risk
175,3,402.08,1,3,2,6,At Risk
17,3,254.91,4,3,2,9,Loyal Customers
1,3,1351.38,4,3,4,11,Champions
2,1,165.62,4,1,1,6,At Risk
24,5,1115.67,3,4,4,11,Champions
38,3,4177.65,3,3,4,10,Loyal Customers
18,3,767.35,3,3,3,9,Loyal Customers
350,1,297.65999999999997,1,1,2,4,Lost
2,1,145.53,4,1,1,6,At Risk
35,2,1297.17,3,2,4,9,Loyal Customers
6,2,133.92000000000002,4,2,1,7,Potential Loyalist
141,1,495.52,2,1,3,6,At Risk
9,7,1696.01,4,4,4,12,Champions
67,3,715.04,2,3,3,8,Potential Loyalist
99,2,590.88,2,2,3,7,Potential Loyalist
38,3,997.85,3,3,3,9,Loyal Customers
43,1,154.86,3,1,1,5,At Risk
3,12,3021.13,4,4,4,12,Champions
15,16,4706.150000000001,4,4,4,12,Champions
38,3,671.22,3,3,3,9,Loyal Customers
42,2,798.1,3,2,3,8,Potential Loyalist
298,4,2992.77,1,3,4,8,Potential Loyalist
28,4,321.4,3,3,2,8,Potential Loyalist
70,4,1307.23,2,3,4,9,Loyal Customers
14,6,1910.63,4,4,4,12,Champions
99,4,506.38000000000005,2,3,3,8,Potential Loyalist
199,2,728.86,1,2,3,6,At Risk
8,4,994.09,4,3,3,10,Loyal Customers
55,3,522.48,2,3,3,8,Potential Loyalist
41,4,1728.57,3,3,4,10,Loyal Customers
311,1,116.97999999999999,1,1,1,3,Lost
36,2,396.86,3,2,2,7,Potential Loyalist
351,1,245.35000000000002,1,1,2,4,Lost
164,1,199.44,1,1,1,3,Lost
48,3,1331.97,3,3,4,10,Loyal Customers
65,14,1463.24,2,4,4,10,Loyal Customers
91,2,517.8199999999999,2,2,3,7,Potential Loyalist
29,1,459.5,3,1,3,7,Potential Loyalist
50,3,399.14,2,3,2,7,Potential Loyalist
246,1,821.49,1,1,3,5,At Risk
62,3,1490.08,2,3,4,9,Loyal Customers
36,4,802.09,3,3,3,9,Loyal Customers
42,1,49.97,3,1,1,5,At Risk
56,1,300.23,2,1,2,5,At Risk
17,5,717.84,4,4,3,11,Champions
25,3,1022.21,3,3,3,9,Loyal Customers
50,2,317.8,2,2,2,6,At Risk
64,4,735.0,2,3,3,8,Potential Loyalist
295,1,80.70000000000002,1,1,1,3,Lost
38,1,108.83999999999999,3,1,1,5,At Risk
9,8,2953.07,4,4,4,12,Champions
30,2,278.04,3,2,2,7,Potential Loyalist
11,2,206.94,4,2,2,8,Potential Loyalist
178,2,109.71000000000001,1,2,1,4,Lost
43,1,110.8,3,1,1,5,At Risk
78,9,1881.4,2,4,4,10,Loyal Customers
128,5,712.24,2,4,3,9,Loyal Customers
37,20,7959.7,3,4,4,11,Champions
10,1,174.6,4,1,1,6,At Risk
7,5,1187.08,4,4,4,12,Champions
32,8,766.8100000000001,3,4,3,10,Loyal Customers
4,7,2769.61,4,4,4,12,Champions
104,3,508.44,2,3,3,8,Potential Loyalist
17,2,42.44,4,2,1,7,Potential Loyalist
58,3,334.8,2,3,2,7,Potential Loyalist
32,3,460.18,3,3,3,9,Loyal Customers
93,1,163.18,2,1,1,4,Lost
14,14,2091.66,4,4,4,12,Champions
269,2,119.4,1,2,1,4,Lost
24,1,337.34000000000003,3,1,2,6,At Risk
6,2,302.93,4,2,2,8,Potential Loyalist
55,7,1584.3500000000001,2,4,4,10,Loyal Customers
9,1,234.31,4,1,2,7,Potential Loyalist
361,1,306.43,1,1,2,4,Lost
304,4,216.19,1,3,2,6,At Risk
190,4,425.76000000000005,1,3,2,6,At Risk
25,1,121.06,3,1,1,5,At Risk
85,1,258.55,2,1,2,5,At Risk
52,1,104.5,2,1,1,4,Lost
72,1,91.81,2,1,1,4,Lost
148,2,360.47,1,2,2,5,At Risk
218,1,407.16,1,1,2,4,Lost
245,2,255.60000000000002,1,2,2,5,At Risk
141,1,21.85,2,1,1,4,Lost
186,2,96.43,1,2,1,4,Lost
218,4,557.44,1,3,3,7,Potential Loyalist
360,1,43.5,1,1,1,3,Lost
15,1,351.11,4,1,2,7,Potential Loyalist
8,3,284.91,4,3,2,9,Loyal Customers
1,7,2050.44,4,4,4,12,Champions
11,7,1247.79,4,4,4,12,Champions
168,2,448.02,1,2,2,5,At Risk
165,1,191.94,1,1,1,3,Lost
7,7,1024.18,4,4,3,11,Champions
170,2,254.67000000000002,1,2,2,5,At Risk
8,7,1091.72,4,4,3,11,Champions
239,1,60.550000000000004,1,1,1,3,Lost
182,2,334.23,1,2,2,5,At Risk
11,2,589.44,4,2,3,9,Loyal Customers
146,4,158.55,1,3,1,5,At Risk
164,1,164.06,1,1,1,3,Lost
365,1,208.10000000000002,1,1,2,4,Lost
364,1,78.3,1,1,1,3,Lost
186,1,168.9,1,1,1,3,Lost
59,1,393.63,2,1,2,5,At Risk
80,7,1386.83,2,4,4,10,Loyal Customers
13,3,1035.05,4,3,3,10,Loyal Customers
231,1,91.04,1,1,1,3,Lost
56,1,145.35,2,1,1,4,Lost
104,5,297.58,2,4,2,8,Potential Loyalist
81,11,834.16,2,4,3,9,Loyal Customers
125,1,255.54,2,1,2,5,At Risk
268,1,149.9,1,1,1,3,Lost
357,1,13.6,1,1,1,3,Lost
74,1,349.64,2,1,2,5,At Risk
35,1,620.84,3,1,3,7,Potential Loyalist
8,2,349.6,4,2,2,8,Potential Loyalist
23,4,1607.71,3,3,4,10,Loyal Customers
277,1,321.02,1,1,2,4,Lost
25,4,694.7,3,3,3,9,Loyal Customers
7,8,958.03,4,4,3,11,Champions
16,14,3714.51,4,4,4,12,Champions
23,1,399.04,3,1,2,6,At Risk
66,1,87.85,2,1,1,4,Lost
11,2,434.36,4,2,2,8,Potential Loyalist
9,4,788.77,4,3,3,10,Loyal Customers
15,2,373.43,4,2,2,8,Potential Loyalist
41,2,237.3,3,2,2,7,Potential Loyalist
295,1,314.1,1,1,2,4,Lost
44,7,273.05,3,4,2,9,Loyal Customers
358,1,34.4,1,1,1,3,Lost
31,7,2880.81,3,4,4,11,Champions
76,1,371.01,2,1,2,5,At Risk
157,2,379.08,1,2,2,5,At Risk
9,2,633.32,4,2,3,9,Loyal Customers
69,1,942.58,2,1,3,6,At Risk
80,3,1250.0,2,3,4,9,Loyal Customers
16,8,2328.48,4,4,4,12,Champions
14,4,1129.81,4,3,4,11,Champions
92,7,1475.26,2,4,4,10,Loyal Customers
115,2,569.1800000000001,2,2,3,7,Potential Loyalist
22,1,126.11999999999999,3,1,1,5,At Risk
4,5,524.95,4,4,3,11,Champions
11,1,113.38,4,1,1,6,At Risk
36,2,604.01,3,2,3,8,Potential Loyalist
8,5,2104.14,4,4,4,12,Champions
46,1,355.17,3,1,2,6,At Risk
80,6,796.48,2,4,3,9,Loyal Customers
28,5,2473.86,3,4,4,11,Champions
21,5,1628.8700000000001,3,4,4,11,Champions
4,4,506.74,4,3,3,10,Loyal Customers
203,1,101.4,1,1,1,3,Lost
39,4,1600.75,3,3,4,10,Loyal Customers
15,3,428.26,4,3,2,9,Loyal Customers
14,4,685.76,4,3,3,10,Loyal Customers
237,3,407.5,1,3,2,6,At Risk
21,15,2886.19,3,4,4,11,Champions
27,3,984.87,3,3,3,9,Loyal Customers
10,6,703.3,4,4,3,11,Champions
29,3,570.13,3,3,3,9,Loyal Customers
18,2,449.90999999999997,3,2,2,7,Potential Loyalist
6,7,1140.71,4,4,4,12,Champions
39,1,172.03,3,1,1,5,At Risk
31,2,332.46,3,2,2,7,Potential Loyalist
38,9,2397.83,3,4,4,11,Champions
8,3,707.01,4,3,3,10,Loyal Customers
252,1,549.4300000000001,1,1,3,5,At Risk
38,3,548.86,3,3,3,9,Loyal Customers
4,1,224.6,4,1,2,7,Potential Loyalist
21,1,423.15999999999997,3,1,2,6,At Risk
35,1,236.09,3,1,2,6,At Risk
129,3,64.75,2,3,1,6,At Risk
57,16,1324.35,2,4,4,10,Loyal Customers
301,1,312.85,1,1,2,4,Lost
84,2,435.09000000000003,2,2,2,6,At Risk
25,19,6575.58,3,4,4,11,Champions
188,3,407.1,1,3,2,6,At Risk
79,2,607.69,2,2,3,7,Potential Loyalist
261,3,675.4200000000001,1,3,3,7,Potential Loyalist
169,2,353.53000000000003,1,2,2,5,At Risk
57,3,1018.86,2,3,3,8,Potential Loyalist
13,5,1115.07,4,4,4,12,Champions
29,4,598.74,3,3,3,9,Loyal Customers
111,4,1133.4,2,3,4,9,Loyal Customers
365,2,256.44,1,2,2,5,At Risk
32,3,1010.97,3,3,3,9,Loyal Customers
165,1,77.48,1,1,1,3,Lost
46,1,303.54,3,1,2,6,At Risk
24,2,1075.45,3,2,3,8,Potential Loyalist
137,1,608.5600000000001,2,1,3,6,At Risk
212,1,78.0,1,1,1,3,Lost
37,1,490.0,3,1,3,7,Potential Loyalist
8,7,1955.47,4,4,4,12,Champions
57,6,1310.21,2,4,4,10,Loyal Customers
1,4,571.52,4,3,3,10,Loyal Customers
252,1,335.32,1,1,2,4,Lost
357,1,322.79,1,1,2,4,Lost
8,5,1086.57,4,4,3,11,Champions
14,2,852.15,4,2,3,9,Loyal Customers
36,1,299.29,3,1,2,6,At Risk
280,1,138.15,1,1,1,3,Lost
14,8,1841.98,4,4,4,12,Champions
275,1,79.2,1,1,1,3,Lost
8,3,98.34,4,3,1,8,Potential Loyalist
73,2,217.16,2,2,2,6,At Risk
48,5,2328.85,3,4,4,11,Champions
92,2,606.14,2,2,3,7,Potential Loyalist
291,1,397.58,1,1,2,4,Lost
15,5,852.4,4,4,3,11,Champions
51,5,794.0600000000001,2,4,3,9,Loyal Customers
146,2,315.06,1,2,2,5,At Risk
106,3,752.5600000000001,2,3,3,8,Potential Loyalist
98,1,17.0,2,1,1,4,Lost
3,4,847.93,4,3,3,10,Loyal Customers
256,1,124.62,1,1,1,3,Lost
232,1,110.4,1,1,1,3,Lost
79,7,1107.51,2,4,4,10,Loyal Customers
42,3,731.9,3,3,3,9,Loyal Customers
62,1,1261.7,2,1,4,7,Potential Loyalist
34,3,1562.74,3,3,4,10,Loyal Customers
71,4,644.6,2,3,3,8,Potential Loyalist
53,1,243.56,2,1,2,5,At Risk
240,1,165.6,1,1,1,3,Lost
57,1,108.38,2,1,1,4,Lost
20,6,577.9000000000001,3,4,3,10,Loyal Customers
76,1,811.58,2,1,3,6,At Risk
210,2,208.32,1,2,2,5,At Risk
37,3,1248.68,3,3,4,10,Loyal Customers
135,2,100.7,2,2,1,5,At Risk
175,1,110.15,1,1,1,3,Lost
162,1,135.75000000000003,1,1,1,3,Lost
1,8,1519.47,4,4,4,12,Champions
203,1,446.98,1,1,2,4,Lost
181,1,195.31,1,1,1,3,Lost
64,1,250.08,2,1,2,5,At Risk
51,3,588.1,2,3,3,8,Potential Loyalist
49,2,829.96,3,2,3,8,Potential Loyalist
65,4,342.18,2,3,2,7,Potential Loyalist
43,1,254.88,3,1,2,6,At Risk
309,1,113.4,1,1,1,3,Lost
359,1,273.45,1,1,2,4,Lost
21,4,4571.2300000000005,3,3,4,10,Loyal Customers
31,1,656.25,3,1,3,7,Potential Loyalist
9,5,1819.27,4,4,4,12,Champions
43,5,1984.6399999999999,3,4,4,11,Champions
8,28,5131.47,4,4,4,12,Champions
13,2,586.29,4,2,3,9,Loyal Customers
254,1,313.7,1,1,2,4,Lost
51,3,535.94,2,3,3,8,Potential Loyalist
10,3,635.41,4,3,3,10,Loyal Customers
57,2,501.9,2,2,3,7,Potential Loyalist
80,1,430.70000000000005,2,1,2,5,At Risk
241,1,356.04,1,1,2,4,Lost
100,5,1472.6100000000001,2,4,4,10,Loyal Customers
32,10,2867.96,3,4,4,11,Champions
195,2,557.13,1,2,3,6,At Risk
125,1,243.08,2,1,2,5,At Risk
134,1,154.56,2,1,1,4,Lost
34,5,1841.32,3,4,4,11,Champions
260,1,712.46,1,1,3,5,At Risk
41,5,1463.53,3,4,4,11,Champions
16,8,2597.9300000000003,4,4,4,12,Champions
7,3,369.95000000000005,4,3,2,9,Loyal Customers
273,1,348.2,1,1,2,4,Lost
57,1,173.09999999999997,2,1,1,4,Lost
6,18,4488.3,4,4,4,12,Champions
244,1,11.9,1,1,1,3,Lost
357,1,50.1,1,1,1,3,Lost
9,3,678.54,4,3,3,10,Loyal Customers
2,23,1838.22,4,4,4,12,Champions
21,3,1333.68,3,3,4,10,Loyal Customers
42,6,1598.52,3,4,4,11,Champions
51,1,73.2,2,1,1,4,Lost
87,5,1091.31,2,4,3,9,Loyal Customers
7,6,1216.6200000000001,4,4,4,12,Champions
118,2,313.0,2,2,2,6,At Risk
86,4,885.09,2,3,3,8,Potential Loyalist
42,1,179.35,3,1,1,5,At Risk
130,1,150.1,2,1,1,4,Lost
52,1,177.58,2,1,1,4,Lost
92,8,1928.33,2,4,4,10,Loyal Customers
65,1,163.94,2,1,1,4,Lost
64,1,72.8,2,1,1,4,Lost
59,1,338.71000000000004,2,1,2,5,At Risk
55,6,722.58,2,4,3,9,Loyal Customers
8,2,473.26,4,2,3,9,Loyal Customers
14,12,3643.08,4,4,4,12,Champions
23,15,5428.56,3,4,4,11,Champions
36,4,910.87,3,3,3,9,Loyal Customers
7,2,125.57999999999998,4,2,1,7,Potential Loyalist
32,1,94.99000000000001,3,1,1,5,At Risk
15,10,2536.36,4,4,4,12,Champions
228,1,280.63,1,1,2,4,Lost
67,1,286.281,2,1,2,5,At Risk
156,1,416.27,1,1,2,4,Lost
13,3,1284.6,4,3,4,11,Champions
352,1,247.52,1,1,2,4,Lost
50,4,592.9,2,3,3,8,Potential Loyalist
15,1,405.71,4,1,2,7,Potential Loyalist
22,4,613.68,3,3,3,9,Loyal Customers
46,4,502.71000000000004,3,3,3,9,Loyal Customers
17,1,310.38,4,1,2,7,Potential Loyalist
36,2,534.06,3,2,3,8,Potential Loyalist
80,4,744.28,2,3,3,8,Potential Loyalist
1,13,1563.52,4,4,4,12,Champions
80,1,329.22,2,1,2,5,At Risk
11,2,552.09,4,2,3,9,Loyal Customers
70,1,82.5,2,1,1,4,Lost
162,3,653.45,1,3,3,7,Potential Loyalist
72,1,186.9,2,1,1,4,Lost
259,1,605.88,1,1,3,5,At Risk
227,2,288.45000000000005,1,2,2,5,At Risk
21,5,1186.38,3,4,4,11,Champions
28,3,672.08,3,3,3,9,Loyal Customers
310,1,677.9200000000001,1,1,3,5,At Risk
48,4,1072.85,3,3,3,9,Loyal Customers
36,5,1077.8700000000001,3,4,3,10,Loyal Customers
195,3,181.20000000000002,1,3,1,5,At Risk
217,1,314.22,1,1,2,4,Lost
79,2,836.6,2,2,3,7,Potential Loyalist
181,2,516.53,1,2,3,6,At Risk
35,4,795.88,3,3,3,9,Loyal Customers
63,2,373.38,2,2,2,6,At Risk
32,4,595.71,3,3,3,9,Loyal Customers
70,1,416.3,2,1,2,5,At Risk
48,2,363.2,3,2,2,7,Potential Loyalist
16,2,2055.47,4,2,4,10,Loyal Customers
1,13,2304.71,4,4,4,12,Champions
10,6,2695.52,4,4,4,12,Champions
25,2,227.4,3,2,2,7,Potential Loyalist
203,2,1475.05,1,2,4,7,Potential Loyalist
15,3,1217.76,4,3,4,11,Champions
162,1,56.28,1,1,1,3,Lost
53,1,152.94,2,1,1,4,Lost
44,5,1103.39,3,4,3,10,Loyal Customers
253,2,373.54,1,2,2,5,At Risk
58,2,2191.18,2,2,4,8,Potential Loyalist
8,8,2180.61,4,4,4,12,Champions
258,1,169.95000000000002,1,1,1,3,Lost
37,5,3245.31,3,4,4,11,Champions
42,1,427.45000000000005,3,1,2,6,At Risk
9,4,615.38,4,3,3,10,Loyal Customers
1,9,4018.51,4,4,4,12,Champions
65,7,607.99,2,4,3,9,Loyal Customers
62,2,495.2,2,2,3,7,Potential Loyalist
345,1,685.99,1,1,3,5,At Risk
7,4,1246.45,4,3,4,11,Champions
108,1,411.7,2,1,2,5,At Risk
365,1,201.65,1,1,1,3,Lost
188,1,322.12,1,1,2,4,Lost
168,1,177.0,1,1,1,3,Lost
92,1,211.03,2,1,2,5,At Risk
13,3,1399.8,4,3,4,11,Champions
64,1,121.5,2,1,1,4,Lost
331,1,129.75,1,1,1,3,Lost
60,4,1081.44,2,3,3,8,Potential Loyalist
23,2,771.13,3,2,3,8,Potential Loyalist
161,1,125.22000000000001,1,1,1,3,Lost
113,1,282.35,2,1,2,5,At Risk
13,10,1877.74,4,4,4,12,Champions
1,4,967.26,4,3,3,10,Loyal Customers
260,1,277.34000000000003,1,1,2,4,Lost
14,3,385.2,4,3,2,9,Loyal Customers
118,1,233.22,2,1,2,5,At Risk
17,3,3904.43,4,3,4,11,Champions
130,1,361.21999999999997,2,1,2,5,At Risk
205,6,585.17,1,4,3,8,Potential Loyalist
98,2,666.77,2,2,3,7,Potential Loyalist
9,2,568.89,4,2,3,9,Loyal Customers
41,1,134.12,3,1,1,5,At Risk
322,1,155.52,1,1,1,3,Lost
56,7,1803.72,2,4,4,10,Loyal Customers
111,3,1055.63,2,3,3,8,Potential Loyalist
27,1,304.75,3,1,2,6,At Risk
209,1,404.40000000000003,1,1,2,4,Lost
164,2,922.64,1,2,3,6,At Risk
64,5,346.8,2,4,2,8,Potential Loyalist
28,1,193.18,3,1,1,5,At Risk
120,3,389.98,2,3,2,7,Potential Loyalist
38,3,560.74,3,3,3,9,Loyal Customers
7,13,1222.27,4,4,4,12,Champions
6,6,3194.01,4,4,4,12,Champions
9,3,122.66,4,3,1,8,Potential Loyalist
20,7,1242.3,3,4,4,11,Champions
28,1,133.15,3,1,1,5,At Risk
149,1,199.85,1,1,1,3,Lost
276,1,30.45,1,1,1,3,Lost
99,1,480.2,2,1,3,6,At Risk
16,4,1040.37,4,3,3,10,Loyal Customers
67,4,193.96,2,3,1,6,At Risk
7,2,310.78,4,2,2,8,Potential Loyalist
150,1,101.10000000000001,1,1,1,3,Lost
36,1,421.76,3,1,2,6,At Risk
3,2,660.7800000000001,4,2,3,9,Loyal Customers
24,7,1147.95,3,4,4,11,Champions
282,1,12.65,1,1,1,3,Lost
13,4,932.7,4,3,3,10,Loyal Customers
324,1,153.9,1,1,1,3,Lost
9,2,494.44,4,2,3,9,Loyal Customers
9,16,2745.05,4,4,4,12,Champions
55,2,361.40000000000003,2,2,2,6,At Risk
189,3,211.77,1,3,2,6,At Risk
25,3,538.6800000000001,3,3,3,9,Loyal Customers
55,3,1594.3400000000001,2,3,4,9,Loyal Customers
86,7,365.28000000000003,2,4,2,8,Potential Loyalist
11,5,2335.22,4,4,4,12,Champions
1,4,716.8100000000001,4,3,3,10,Loyal Customers
24,5,684.08,3,4,3,10,Loyal Customers
45,1,75.36,3,1,1,5,At Risk
3,2,468.89,4,2,3,9,Loyal Customers
9,7,547.61,4,4,3,11,Champions
10,1,281.90000000000003,4,1,2,7,Potential Loyalist
29,2,700.58,3,2,3,8,Potential Loyalist
20,1,277.58000000000004,3,1,2,6,At Risk
10,3,1317.29,4,3,4,11,Champions
74,4,987.91,2,3,3,8,Potential Loyalist
25,2,283.68,3,2,2,7,Potential Loyalist
58,2,402.58,2,2,2,6,At Risk
9,1,670.23,4,1,3,8,Potential Loyalist
239,3,362.95,1,3,2,6,At Risk
10,3,1605.04,4,3,4,11,Champions
53,1,142.79,2,1,1,4,Lost
66,2,532.24,2,2,3,7,Potential Loyalist
81,2,502.2,2,2,3,7,Potential Loyalist
52,3,479.04,2,3,3,8,Potential Loyalist
20,2,287.7,3,2,2,7,Potential Loyalist
314,1,94.36,1,1,1,3,Lost
45,4,807.51,3,3,3,9,Loyal Customers
261,1,213.54,1,1,2,4,Lost
3,12,2724.39,4,4,4,12,Champions
48,5,786.44,3,4,3,10,Loyal Customers
52,5,1275.48,2,4,4,10,Loyal Customers
146,2,972.95,1,2,3,6,At Risk
11,2,326.55,4,2,2,8,Potential Loyalist
86,1,271.08,2,1,2,5,At Risk
6,11,2457.42,4,4,4,12,Champions
256,2,214.75,1,2,2,5,At Risk
304,1,177.5,1,1,1,3,Lost
62,1,296.45,2,1,2,5,At Risk
294,2,74.85,1,2,1,4,Lost
10,1,155.12,4,1,1,6,At Risk
4,9,1686.23,4,4,4,12,Champions
28,5,1743.04,3,4,4,11,Champions
11,2,206.7,4,2,2,8,Potential Loyalist
45,1,151.83,3,1,1,5,At Risk
48,1,247.25,3,1,2,6,At Risk
13,2,31.6,4,2,1,7,Potential Loyalist
36,1,191.7,3,1,1,5,At Risk
18,3,752.3,3,3,3,9,Loyal Customers
36,3,511.82,3,3,3,9,Loyal Customers
104,6,535.61,2,4,3,9,Loyal Customers
9,37,3487.44,4,4,4,12,Champions
16,1,268.78,4,1,2,7,Potential Loyalist
183,1,70.56,1,1,1,3,Lost
294,1,157.4,1,1,1,3,Lost
13,7,1130.29,4,4,4,12,Champions
255,2,166.06,1,2,1,4,Lost
98,1,4.95,2,1,1,4,Lost
49,1,200.05,3,1,1,5,At Risk
205,3,567.21,1,3,3,7,Potential Loyalist
56,1,111.0,2,1,1,4,Lost
20,1,120.66,3,1,1,5,At Risk
21,7,1202.85,3,4,4,11,Champions
18,4,598.79,3,3,3,9,Loyal Customers
21,4,2527.84,3,3,4,10,Loyal Customers
58,2,358.75,2,2,2,6,At Risk
219,2,349.38,1,2,2,5,At Risk
38,4,552.17,3,3,3,9,Loyal Customers
25,1,208.06,3,1,2,6,At Risk
197,1,2.9,1,1,1,3,Lost
127,1,119.66,2,1,1,4,Lost
190,1,163.39000000000001,1,1,1,3,Lost
189,2,606.54,1,2,3,6,At Risk
141,1,311.92,2,1,2,5,At Risk
79,1,266.97,2,1,2,5,At Risk
36,2,6.9,3,2,1,6,At Risk
55,7,1841.18,2,4,4,10,Loyal Customers
91,5,1407.32,2,4,4,10,Loyal Customers
210,1,161.56,1,1,1,3,Lost
6,17,3293.8,4,4,4,12,Champions
20,3,729.49,3,3,3,9,Loyal Customers
169,1,76.67,1,1,1,3,Lost
13,4,1295.48,4,3,4,11,Champions
11,3,1103.27,4,3,3,10,Loyal Customers
25,7,1375.92,3,4,4,11,Champions
15,4,548.18,4,3,3,10,Loyal Customers
43,4,674.52,3,3,3,9,Loyal Customers
266,1,223.95000000000002,1,1,2,4,Lost
156,3,289.16,1,3,2,6,At Risk
9,5,1637.49,4,4,4,12,Champions
135,3,417.7,2,3,2,7,Potential Loyalist
55,7,2450.7200000000003,2,4,4,10,Loyal Customers
17,2,251.26000000000002,4,2,2,8,Potential Loyalist
2,2,255.63,4,2,2,8,Potential Loyalist
67,1,416.57,2,1,2,5,At Risk
7,1,167.34,4,1,1,6,At Risk
184,1,95.7,1,1,1,3,Lost
165,2,376.8,1,2,2,5,At Risk
69,1,279.35,2,1,2,5,At Risk
25,3,290.3,3,3,2,8,Potential Loyalist
38,1,617.84,3,1,3,7,Potential Loyalist
71,4,1002.6,2,3,3,8,Potential Loyalist
288,1,723.93,1,1,3,5,At Risk
268,1,171.71,1,1,1,3,Lost
199,2,892.07,1,2,3,6,At Risk
41,6,2296.79,3,4,4,11,Champions
153,2,93.02,1,2,1,4,Lost
352,2,294.55,1,2,2,5,At Risk
8,4,183.12,4,3,1,8,Potential Loyalist
98,4,1124.28,2,3,4,9,Loyal Customers
17,1,470.34,4,1,3,8,Potential Loyalist
11,2,90.30000000000001,4,2,1,7,Potential Loyalist
288,1,169.50000000000003,1,1,1,3,Lost
364,1,178.54999999999998,1,1,1,3,Lost
13,3,699.26,4,3,3,10,Loyal Customers
11,2,662.7900000000001,4,2,3,9,Loyal Customers
44,5,1370.53,3,4,4,11,Champions
22,1,101.69999999999999,3,1,1,5,At Risk
269,1,154.75,1,1,1,3,Lost
53,2,376.07,2,2,2,6,At Risk
17,2,74.38,4,2,1,7,Potential Loyalist
178,3,912.72,1,3,3,7,Potential Loyalist
7,17,4558.91,4,4,4,12,Champions
8,25,3936.79,4,4,4,12,Champions
163,1,237.66,1,1,2,4,Lost
73,1,219.81,2,1,2,5,At Risk
182,1,391.65000000000003,1,1,2,4,Lost
14,7,1050.32,4,4,3,11,Champions
11,3,896.97,4,3,3,10,Loyal Customers
102,1,357.02000000000004,2,1,2,5,At Risk
211,3,1037.71,1,3,3,7,Potential Loyalist
45,1,119.62,3,1,1,5,At Risk
156,1,101.7,1,1,1,3,Lost
282,2,564.95,1,2,3,6,At Risk
2,10,3770.54,4,4,4,12,Champions
100,5,1934.1000000000001,2,4,4,10,Loyal Customers
87,3,426.38,2,3,2,7,Potential Loyalist
234,2,189.19000000000003,1,2,1,4,Lost
197,6,977.24,1,4,3,8,Potential Loyalist
34,3,742.8,3,3,3,9,Loyal Customers
27,2,269.39,3,2,2,7,Potential Loyalist
58,7,2316.6,2,4,4,10,Loyal Customers
16,2,174.1,4,2,1,7,Potential Loyalist
14,19,5871.49,4,4,4,12,Champions
18,2,652.66,3,2,3,8,Potential Loyalist
51,1,264.96,2,1,2,5,At Risk
45,1,324.5,3,1,2,6,At Risk
356,1,35.7,1,1,1,3,Lost
7,5,287.28000000000003,4,4,2,10,Loyal Customers
186,2,561.4,1,2,3,6,At Risk
7,9,2176.71,4,4,4,12,Champions
18,3,1249.37,3,3,4,10,Loyal Customers
119,3,855.55,2,3,3,8,Potential Loyalist
76,2,525.96,2,2,3,7,Potential Loyalist
63,1,409.14,2,1,2,5,At Risk
174,1,105.84,1,1,1,3,Lost
105,1,50.099999999999994,2,1,1,4,Lost
365,1,233.45,1,1,2,4,Lost
72,2,675.38,2,2,3,7,Potential Loyalist
240,1,361.95,1,1,2,4,Lost
224,1,127.85000000000001,1,1,1,3,Lost
63,3,459.24,2,3,3,8,Potential Loyalist
60,1,213.5,2,1,2,5,At Risk
4,15,2848.69,4,4,4,12,Champions
42,2,104.47999999999999,3,2,1,6,At Risk
67,1,123.44,2,1,1,4,Lost
53,1,341.96,2,1,2,5,At Risk
7,2,193.85000000000002,4,2,1,7,Potential Loyalist
277,1,145.04999999999998,1,1,1,3,Lost
8,5,436.5,4,4,2,10,Loyal Customers
32,1,163.01,3,1,1,5,At Risk
28,1,497.21,3,1,3,7,Potential Loyalist
66,2,465.97,2,2,3,7,Potential Loyalist
9,12,2374.72,4,4,4,12,Champions
7,7,4808.900000000001,4,4,4,12,Champions
211,1,75.66,1,1,1,3,Lost
178,1,129.49,1,1,1,3,Lost
24,4,1036.76,3,3,3,9,Loyal Customers
62,1,586.79,2,1,3,6,At Risk
174,1,305.79,1,1,2,4,Lost
7,2,420.52,4,2,2,8,Potential Loyalist
227,1,79.1,1,1,1,3,Lost
23,4,1561.08,3,3,4,10,Loyal Customers
255,1,226.21,1,1,2,4,Lost
252,1,61.76,1,1,1,3,Lost
43,4,282.71000000000004,3,3,2,8,Potential Loyalist
237,1,129.45,1,1,1,3,Lost
72,2,439.49,2,2,2,6,At Risk
266,1,300.68,1,1,2,4,Lost
14,14,2051.61,4,4,4,12,Champions
71,1,162.38,2,1,1,4,Lost
21,5,1963.05,3,4,4,11,Champions
65,2,338.05,2,2,2,6,At Risk
9,6,2259.55,4,4,4,12,Champions
214,2,172.5,1,2,1,4,Lost
24,4,921.76,3,3,3,9,Loyal Customers
14,10,1125.55,4,4,4,12,Champions
23,3,974.01,3,3,3,9,Loyal Customers
97,1,123.38,2,1,1,4,Lost
199,1,169.33,1,1,1,3,Lost
237,1,401.31,1,1,2,4,Lost
169,2,813.88,1,2,3,6,At Risk
161,2,142.42000000000002,1,2,1,4,Lost
34,1,267.26,3,1,2,6,At Risk
63,1,430.38,2,1,2,5,At Risk
50,5,2879.15,2,4,4,10,Loyal Customers
8,2,1043.31,4,2,3,9,Loyal Customers
133,4,381.87,2,3,2,7,Potential Loyalist
9,6,2726.36,4,4,4,12,Champions
14,12,1325.28,4,4,4,12,Champions
1,4,815.65,4,3,3,10,Loyal Customers
360,1,91.44,1,1,1,3,Lost
181,1,20.4,1,1,1,3,Lost
8,2,205.97,4,2,1,7,Potential Loyalist
354,1,39.25,1,1,1,3,Lost
11,1,118.98,4,1,1,6,At Risk
60,2,472.93,2,2,3,7,Potential Loyalist
6,6,286.56,4,4,2,10,Loyal Customers
15,3,1132.17,4,3,4,11,Champions
8,11,3472.7200000000003,4,4,4,12,Champions
27,1,81.75,3,1,1,5,At Risk
27,16,3892.7999999999997,3,4,4,11,Champions
46,2,309.21,3,2,2,7,Potential Loyalist
25,4,1062.78,3,3,3,9,Loyal Customers
2,11,2240.97,4,4,4,12,Champions
358,1,117.0,1,1,1,3,Lost
35,1,149.7,3,1,1,5,At Risk
69,5,939.64,2,4,3,9,Loyal Customers
49,4,333.06,3,3,2,8,Potential Loyalist
28,7,1318.1399999999999,3,4,4,11,Champions
53,1,227.82,2,1,2,5,At Risk
39,7,2376.23,3,4,4,11,Champions
2,3,855.18,4,3,3,10,Loyal Customers
67,2,293.52,2,2,2,6,At Risk
64,2,156.43,2,2,1,5,At Risk
60,2,366.01,2,2,2,6,At Risk
127,4,462.3,2,3,3,8,Potential Loyalist
233,1,50.85,1,1,1,3,Lost
21,12,4549.56,3,4,4,11,Champions
45,11,1711.01,3,4,4,11,Champions
3,19,6614.57,4,4,4,12,Champions
29,3,398.1,3,3,2,8,Potential Loyalist
37,1,571.03,3,1,3,7,Potential Loyalist
76,5,1667.8300000000002,2,4,4,10,Loyal Customers
11,10,2137.4900000000002,4,4,4,12,Champions
18,2,243.03000000000003,3,2,2,7,Potential Loyalist
10,10,2557.6,4,4,4,12,Champions
10,15,4720.2300000000005,4,4,4,12,Champions
309,1,838.88,1,1,3,5,At Risk
69,1,99.39999999999999,2,1,1,4,Lost
258,1,166.8,1,1,1,3,Lost
15,6,3254.9300000000003,4,4,4,12,Champions
361,1,500.63,1,1,3,5,At Risk
6,7,1284.17,4,4,4,12,Champions
18,1,116.57,3,1,1,5,At Risk
254,1,292.47,1,1,2,4,Lost
9,13,3271.29,4,4,4,12,Champions
99,1,246.99,2,1,2,5,At Risk
294,7,602.6800000000001,1,4,3,8,Potential Loyalist
18,5,1155.43,3,4,4,11,Champions
356,1,272.82,1,1,2,4,Lost
38,4,845.17,3,3,3,9,Loyal Customers
30,21,6386.43,3,4,4,11,Champions
44,3,627.87,3,3,3,9,Loyal Customers
23,1,540.33,3,1,3,7,Potential Loyalist
44,3,465.91,3,3,3,9,Loyal Customers
70,5,2002.2,2,4,4,10,Loyal Customers
289,1,3.75,1,1,1,3,Lost
168,1,238.75,1,1,2,4,Lost
21,7,2097.61,3,4,4,11,Champions
3,7,1046.87,4,4,3,11,Champions
78,17,4431.13,2,4,4,10,Loyal Customers
3,17,4930.13,4,4,4,12,Champions
29,2,590.73,3,2,3,8,Potential Loyalist
9,5,1515.9,4,4,4,12,Champions
36,5,414.13,3,4,2,9,Loyal Customers
22,1,216.01999999999998,3,1,2,6,At Risk
364,1,77.7,1,1,1,3,Lost
50,1,198.92000000000002,2,1,1,4,Lost
106,3,1177.94,2,3,4,9,Loyal Customers
206,1,213.9,1,1,2,4,Lost
310,1,106.83000000000001,1,1,1,3,Lost
57,1,207.86,2,1,2,5,At Risk
22,2,301.2,3,2,2,7,Potential Loyalist
88,1,195.9,2,1,1,4,Lost
11,3,1404.48,4,3,4,11,Champions
190,1,287.45,1,1,2,4,Lost
1,12,2344.28,4,4,4,12,Champions
265,2,989.0,1,2,3,6,At Risk
22,10,3915.91,3,4,4,11,Champions
39,3,223.69,3,3,2,8,Potential Loyalist
252,1,209.14000000000001,1,1,2,4,Lost
49,5,696.0500000000001,3,4,3,10,Loyal Customers
25,5,1823.39,3,4,4,11,Champions
49,1,106.89,3,1,1,5,At Risk
59,4,590.12,2,3,3,8,Potential Loyalist
2,11,1275.26,4,4,4,12,Champions
52,1,373.33,2,1,2,5,At Risk
72,2,138.05,2,2,1,5,At Risk
66,2,228.94,2,2,2,6,At Risk
6,20,7336.4400000000005,4,4,4,12,Champions
92,2,389.74,2,2,2,6,At Risk
364,1,216.8,1,1,2,4,Lost
2,13,1798.3000000000002,4,4,4,12,Champions
11,1,107.6,4,1,1,6,At Risk
115,2,579.03,2,2,3,7,Potential Loyalist
8,5,1321.78,4,4,4,12,Champions
20,7,1430.38,3,4,4,11,Champions
274,1,87.68,1,1,1,3,Lost
49,1,226.84,3,1,2,6,At Risk
2,9,1042.39,4,4,3,11,Champions
357,1,392.18,1,1,2,4,Lost
81,1,305.62,2,1,2,5,At Risk
3,1,856.82,4,1,3,8,Potential Loyalist
155,4,909.53,1,3,3,7,Potential Loyalist
57,1,332.3,2,1,2,5,At Risk
15,3,445.84000000000003,4,3,2,9,Loyal Customers
165,2,365.31,1,2,2,5,At Risk
95,4,637.99,2,3,3,8,Potential Loyalist
134,3,934.6899999999999,2,3,3,8,Potential Loyalist
90,2,222.97,2,2,2,6,At Risk
15,5,882.59,4,4,3,11,Champions
184,1,289.64,1,1,2,4,Lost
9,1,256.93,4,1,2,7,Potential Loyalist
352,1,204.15,1,1,1,3,Lost
42,9,1334.3799999999999,3,4,4,11,Champions
6,21,4975.78,4,4,4,12,Champions
95,4,401.16,2,3,2,7,Potential Loyalist
24,8,1065.28,3,4,3,10,Loyal Customers
2,11,3091.15,4,4,4,12,Champions
87,1,415.94,2,1,2,5,At Risk
219,1,269.68,1,1,2,4,Lost
7,2,402.74,4,2,2,8,Potential Loyalist
30,2,521.48,3,2,3,8,Potential Loyalist
43,1,279.45,3,1,2,6,At Risk
104,1,113.5,2,1,1,4,Lost
148,1,181.32,1,1,1,3,Lost
30,1,325.91,3,1,2,6,At Risk
209,1,39.0,1,1,1,3,Lost
251,3,637.29,1,3,3,7,Potential Loyalist
219,1,413.46,1,1,2,4,Lost
120,2,133.15,2,2,1,5,At Risk
31,2,175.55,3,2,1,6,At Risk
23,9,2083.25,3,4,4,11,Champions
189,2,353.9,1,2,2,5,At Risk
14,27,3565.45,4,4,4,12,Champions
28,6,1692.7,3,4,4,11,Champions
92,3,935.49,2,3,3,8,Potential Loyalist
34,16,7099.72,3,4,4,11,Champions
42,1,197.82,3,1,1,5,At Risk
35,1,176.94,3,1,1,5,At Risk
44,1,281.42,3,1,2,6,At Risk
178,1,84.77,1,1,1,3,Lost
325,1,317.29,1,1,2,4,Lost
34,2,239.45999999999998,3,2,2,7,Potential Loyalist
2,2,70.96000000000001,4,2,1,7,Potential Loyalist
15,2,285.8,4,2,2,8,Potential Loyalist
6,1,35.400000000000006,4,1,1,6,At Risk
360,1,320.04,1,1,2,4,Lost
136,2,587.63,2,2,3,7,Potential Loyalist
51,2,112.80000000000001,2,2,1,5,At Risk
23,2,438.88,3,2,2,7,Potential Loyalist
132,3,108.24000000000001,2,3,1,6,At Risk
14,4,699.09,4,3,3,10,Loyal Customers
13,6,2267.2400000000002,4,4,4,12,Champions
53,5,3718.4900000000002,2,4,4,10,Loyal Customers
59,5,1643.83,2,4,4,10,Loyal Customers
4,6,779.87,4,4,3,11,Champions
75,1,13.3,2,1,1,4,Lost
22,7,821.12,3,4,3,10,Loyal Customers
58,3,529.47,2,3,3,8,Potential Loyalist
179,2,213.03,1,2,2,5,At Risk
29,2,399.96,3,2,2,7,Potential Loyalist
7,3,338.41,4,3,2,9,Loyal Customers
27,1,170.13,3,1,1,5,At Risk
186,3,1273.84,1,3,4,8,Potential Loyalist
28,4,581.2,3,3,3,9,Loyal Customers
7,3,291.87,4,3,2,9,Loyal Customers
358,1,126.03,1,1,1,3,Lost
56,1,191.99,2,1,1,4,Lost
291,2,154.23000000000002,1,2,1,4,Lost
18,3,449.32,3,3,2,8,Potential Loyalist
11,5,738.33,4,4,3,11,Champions
8,3,753.9,4,3,3,10,Loyal Customers
108,1,1094.69,2,1,3,6,At Risk
21,1,336.84,3,1,2,6,At Risk
21,13,2409.25,3,4,4,11,Champions
11,6,1860.79,4,4,4,12,Champions
73,4,344.26,2,3,2,7,Potential Loyalist
20,5,768.2,3,4,3,10,Loyal Customers
64,1,213.72,2,1,2,5,At Risk
1,7,984.71,4,4,3,11,Champions
20,11,1710.88,3,4,4,11,Champions
282,1,53.44,1,1,1,3,Lost
28,1,128.61,3,1,1,5,At Risk
1,5,305.63,4,4,2,10,Loyal Customers
15,2,512.03,4,2,3,9,Loyal Customers
268,1,121.9,1,1,1,3,Lost
41,6,923.52,3,4,3,10,Loyal Customers
148,11,1597.0,1,4,4,9,Loyal Customers
53,1,161.54,2,1,1,4,Lost
4,17,5390.79,4,4,4,12,Champions
13,3,698.25,4,3,3,10,Loyal Customers
363,1,33.45,1,1,1,3,Lost
268,2,139.85,1,2,1,4,Lost
72,17,1900.12,2,4,4,10,Loyal Customers
9,6,1046.67,4,4,3,11,Champions
18,3,293.83,3,3,2,8,Potential Loyalist
11,20,3803.31,4,4,4,12,Champions
45,1,145.44,3,1,1,5,At Risk
231,1,142.01,1,1,1,3,Lost
46,2,786.38,3,2,3,8,Potential Loyalist
17,1,246.89000000000001,4,1,2,7,Potential Loyalist
171,3,1411.56,1,3,4,8,Potential Loyalist
44,3,2879.89,3,3,4,10,Loyal Customers
4,9,1519.79,4,4,4,12,Champions
203,3,431.18,1,3,2,6,At Risk
13,19,4126.04,4,4,4,12,Champions
227,1,339.48,1,1,2,4,Lost
130,3,212.9,2,3,2,7,Potential Loyalist
32,5,592.68,3,4,3,10,Loyal Customers
48,3,741.3000000000001,3,3,3,9,Loyal Customers
126,3,1125.06,2,3,4,9,Loyal Customers
101,2,101.75999999999999,2,2,1,5,At Risk
22,1,20.8,3,1,1,5,At Risk
52,5,966.71,2,4,3,9,Loyal Customers
176,4,373.87,1,3,2,6,At Risk
9,1,225.04,4,1,2,7,Potential Loyalist
231,2,376.84000000000003,1,2,2,5,At Risk
79,1,117.35000000000001,2,1,1,4,Lost
30,3,488.6,3,3,3,9,Loyal Customers
108,1,234.17,2,1,2,5,At Risk
179,1,110.55000000000001,1,1,1,3,Lost
218,1,117.4,1,1,1,3,Lost
36,2,116.05,3,2,1,6,At Risk
181,1,305.09999999999997,1,1,2,4,Lost
99,1,184.61,2,1,1,4,Lost
31,3,522.2,3,3,3,9,Loyal Customers
30,1,116.21,3,1,1,5,At Risk
69,1,294.43,2,1,2,5,At Risk
9,5,1003.99,4,4,3,11,Champions
247,2,789.01,1,2,3,6,At Risk
52,1,384.06,2,1,2,5,At Risk
4,7,1540.13,4,4,4,12,Champions
80,2,2956.29,2,2,4,8,Potential Loyalist
9,9,3875.84,4,4,4,12,Champions
22,1,20.8,3,1,1,5,At Risk
34,5,672.42,3,4,3,10,Loyal Customers
71,2,70.94999999999999,2,2,1,5,At Risk
2,5,1302.16,4,4,4,12,Champions
22,6,1335.2800000000002,3,4,4,11,Champions
280,2,117.0,1,2,1,4,Lost
141,3,105.4,2,3,1,6,At Risk
15,2,289.92,4,2,2,8,Potential Loyalist
14,10,2909.48,4,4,4,12,Champions
77,3,801.3,2,3,3,8,Potential Loyalist
38,2,665.64,3,2,3,8,Potential Loyalist
10,3,471.87,4,3,3,10,Loyal Customers
42,6,675.91,3,4,3,10,Loyal Customers
10,1,171.96,4,1,1,6,At Risk
22,1,270.9,3,1,2,6,At Risk
24,2,256.61,3,2,2,7,Potential Loyalist
20,3,1747.79,3,3,4,10,Loyal Customers
1,18,4930.5599999999995,4,4,4,12,Champions
32,2,748.5,3,2,3,8,Potential Loyalist
3,4,1129.81,4,3,4,11,Champions
23,1,71.0,3,1,1,5,At Risk
37,3,95.85,3,3,1,7,Potential Loyalist
52,3,236.45,2,3,2,7,Potential Loyalist
361,1,20.4,1,1,1,3,Lost
70,6,830.99,2,4,3,9,Loyal Customers
55,1,115.95,2,1,1,4,Lost
3,2,317.95,4,2,2,8,Potential Loyalist
78,3,617.76,2,3,3,8,Potential Loyalist
8,3,585.07,4,3,3,10,Loyal Customers
237,2,347.08,1,2,2,5,At Risk
79,1,1182.32,2,1,4,7,Potential Loyalist
22,1,88.25,3,1,1,5,At Risk
129,1,159.78,2,1,1,4,Lost
18,3,964.65,3,3,3,9,Loyal Customers
113,4,845.92,2,3,3,8,Potential Loyalist
24,4,1144.98,3,3,4,10,Loyal Customers
105,2,210.24,2,2,2,6,At Risk
149,1,248.6,1,1,2,4,Lost
77,3,882.9,2,3,3,8,Potential Loyalist
109,3,772.25,2,3,3,8,Potential Loyalist
13,8,4011.34,4,4,4,12,Champions
88,6,2667.04,2,4,4,10,Loyal Customers
186,1,237.19,1,1,2,4,Lost
20,1,364.74,3,1,2,6,At Risk
122,1,373.08000000000004,2,1,2,5,At Risk
20,5,795.28,3,4,3,10,Loyal Customers
73,3,965.54,2,3,3,8,Potential Loyalist
21,5,2563.81,3,4,4,11,Champions
258,1,50.400000000000006,1,1,1,3,Lost
65,7,1653.0,2,4,4,10,Loyal Customers
305,4,498.08,1,3,3,7,Potential Loyalist
13,7,1276.7,4,4,4,12,Champions
50,3,685.2,2,3,3,8,Potential Loyalist
4,21,4238.99,4,4,4,12,Champions
20,9,2422.9500000000003,3,4,4,11,Champions
106,1,292.24,2,1,2,5,At Risk
20,9,1836.0800000000002,3,4,4,11,Champions
9,4,1143.02,4,3,4,11,Champions
9,4,624.52,4,3,3,10,Loyal Customers
27,3,386.9599999999999,3,3,2,8,Potential Loyalist
27,2,262.28,3,2,2,7,Potential Loyalist
70,1,118.80000000000001,2,1,1,4,Lost
14,1,125.39999999999999,4,1,1,6,At Risk
17,2,211.76,4,2,2,8,Potential Loyalist
25,2,1408.1,3,2,4,9,Loyal Customers
101,3,1219.0,2,3,4,9,Loyal Customers
27,2,2289.9,3,2,4,9,Loyal Customers
115,5,1370.95,2,4,4,10,Loyal Customers
16,5,956.66,4,4,3,11,Champions
20,4,1651.6100000000001,3,3,4,10,Loyal Customers
80,4,1205.44,2,3,4,9,Loyal Customers
23,8,2970.57,3,4,4,11,Champions
41,4,1638.19,3,3,4,10,Loyal Customers
314,1,254.3,1,1,2,4,Lost
14,3,1184.91,4,3,4,11,Champions
7,4,771.84,4,3,3,10,Loyal Customers
2,7,655.57,4,4,3,11,Champions
10,2,948.34,4,2,3,9,Loyal Customers
21,3,1067.18,3,3,3,9,Loyal Customers
151,2,560.98,1,2,3,6,At Risk
25,6,7844.23,3,4,4,11,Champions
21,6,816.7,3,4,3,10,Loyal Customers
157,1,76.1,1,1,1,3,Lost
39,1,200.39000000000001,3,1,1,5,At Risk
25,7,360.23,3,4,2,9,Loyal Customers
174,2,450.5,1,2,2,5,At Risk
280,1,73.35,1,1,1,3,Lost
309,1,157.02,1,1,1,3,Lost
51,1,418.13,2,1,2,5,At Risk
225,1,222.96,1,1,2,4,Lost
111,1,138.32,2,1,1,4,Lost
153,1,263.7,1,1,2,4,Lost
177,1,267.09000000000003,1,1,2,4,Lost
42,1,175.13,3,1,1,5,At Risk
144,5,932.46,2,4,3,9,Loyal Customers
326,1,131.59,1,1,1,3,Lost
39,3,965.49,3,3,3,9,Loyal Customers
7,3,32.400000000000006,4,3,1,8,Potential Loyalist
98,2,244.15,2,2,2,6,At Risk
8,5,635.77,4,4,3,11,Champions
267,1,288.3,1,1,2,4,Lost
7,12,7858.57,4,4,4,12,Champions
239,1,126.62,1,1,1,3,Lost
230,1,119.7,1,1,1,3,Lost
76,1,293.65,2,1,2,5,At Risk
255,2,400.98,1,2,2,5,At Risk
14,4,1270.07,4,3,4,11,Champions
43,1,124.88,3,1,1,5,At Risk
186,3,408.8,1,3,2,6,At Risk
16,1,213.78,4,1,2,7,Potential Loyalist
67,1,299.1,2,1,2,5,At Risk
9,2,78.2,4,2,1,7,Potential Loyalist
168,1,161.46,1,1,1,3,Lost
24,3,954.77,3,3,3,9,Loyal Customers
13,3,1436.45,4,3,4,11,Champions
23,6,3356.97,3,4,4,11,Champions
20,10,1293.26,3,4,4,11,Champions
13,2,293.1,4,2,2,8,Potential Loyalist
24,7,2336.2,3,4,4,11,Champions
276,1,122.88,1,1,1,3,Lost
30,2,206.34,3,2,2,7,Potential Loyalist
49,2,751.76,3,2,3,8,Potential Loyalist
281,1,199.41,1,1,1,3,Lost
70,1,224.28,2,1,2,5,At Risk
2,7,2669.7000000000003,4,4,4,12,Champions
209,1,59.9,1,1,1,3,Lost
36,4,968.98,3,3,3,9,Loyal Customers
193,1,208.03,1,1,2,4,Lost
170,3,701.84,1,3,3,7,Potential Loyalist
48,4,673.12,3,3,3,9,Loyal Customers
49,1,44.6,3,1,1,5,At Risk
14,5,1733.23,4,4,4,12,Champions
218,1,114.35,1,1,1,3,Lost
3,7,1430.71,4,4,4,12,Champions
97,2,265.55,2,2,2,6,At Risk
50,1,228.74,2,1,2,5,At Risk
20,7,1797.01,3,4,4,11,Champions
27,7,1088.8600000000001,3,4,3,10,Loyal Customers
352,1,76.12,1,1,1,3,Lost
21,1,463.81,3,1,3,7,Potential Loyalist
15,3,354.97,4,3,2,9,Loyal Customers
45,1,155.73,3,1,1,5,At Risk
27,6,902.81,3,4,3,10,Loyal Customers
167,4,1091.3600000000001,1,3,3,7,Potential Loyalist
45,1,20.5,3,1,1,5,At Risk
45,1,204.24,3,1,1,5,At Risk
18,8,1798.93,3,4,4,11,Champions
244,1,3.95,1,1,1,3,Lost
32,7,2176.2000000000003,3,4,4,11,Champions
52,6,730.07,2,4,3,9,Loyal Customers
226,1,97.6,1,1,1,3,Lost
3,9,1454.94,4,4,4,12,Champions
23,1,105.98,3,1,1,5,At Risk
16,14,2796.43,4,4,4,12,Champions
27,1,132.28,3,1,1,5,At Risk
57,1,298.5,2,1,2,5,At Risk
302,2,234.99,1,2,2,5,At Risk
300,1,148.99,1,1,1,3,Lost
10,6,369.86,4,4,2,10,Loyal Customers
7,8,1798.95,4,4,4,12,Champions
88,2,308.81,2,2,2,6,At Risk
256,6,1514.0,1,4,4,9,Loyal Customers
4,10,2685.82,4,4,4,12,Champions
6,1,208.04,4,1,2,7,Potential Loyalist
27,1,131.07,3,1,1,5,At Risk
174,1,114.04,1,1,1,3,Lost
17,2,357.46,4,2,2,8,Potential Loyalist
4,6,787.58,4,4,3,11,Champions
3,2,306.74,4,2,2,8,Potential Loyalist
9,15,2741.54,4,4,4,12,Champions
304,1,295.0,1,1,2,4,Lost
100,2,915.04,2,2,3,7,Potential Loyalist
6,24,5202.5,4,4,4,12,Champions
45,1,532.53,3,1,3,7,Potential Loyalist
196,1,171.45,1,1,1,3,Lost
7,1,208.09,4,1,2,7,Potential Loyalist
112,1,277.85,2,1,2,5,At Risk
253,1,142.7,1,1,1,3,Lost
354,1,249.28,1,1,2,4,Lost
108,2,299.26,2,2,2,6,At Risk
10,1,113.01,4,1,1,6,At Risk
7,1,134.16,4,1,1,6,At Risk
32,2,260.38,3,2,2,7,Potential Loyalist
99,2,150.29999999999998,2,2,1,5,At Risk
140,2,507.47,2,2,3,7,Potential Loyalist
44,3,391.81,3,3,2,8,Potential Loyalist
200,1,63.440000000000005,1,1,1,3,Lost
130,2,510.1,2,2,3,7,Potential Loyalist
139,1,52.46,2,1,1,4,Lost
119,2,209.77,2,2,2,6,At Risk
142,1,35.0,2,1,1,4,Lost
38,3,1868.67,3,3,4,10,Loyal Customers
27,1,85.42,3,1,1,5,At Risk
219,2,958.0500000000001,1,2,3,6,At Risk
233,1,206.09,1,1,2,4,Lost
49,1,25.43,3,1,1,5,At Risk
165,2,373.2,1,2,2,5,At Risk
52,6,1591.18,2,4,4,10,Loyal Customers
13,1,145.42,4,1,1,6,At Risk
18,7,709.51,3,4,3,10,Loyal Customers
1,6,799.45,4,4,3,11,Champions
23,3,890.96,3,3,3,9,Loyal Customers
8,1,274.46,4,1,2,7,Potential Loyalist
22,7,1289.06,3,4,4,11,Champions
20,3,400.12,3,3,2,8,Potential Loyalist
9,1,95.43,4,1,1,6,At Risk
93,2,270.68,2,2,2,6,At Risk
3,4,544.75,4,3,3,10,Loyal Customers
13,1,166.43,4,1,1,6,At Risk
6,5,1044.48,4,4,3,11,Champions
353,1,192.24,1,1,1,3,Lost
2,3,109.92,4,3,1,8,Potential Loyalist
87,1,82.75,2,1,1,4,Lost
70,2,727.84,2,2,3,7,Potential Loyalist
146,2,96.35000000000001,1,2,1,4,Lost
23,1,210.60000000000002,3,1,2,6,At Risk
16,8,2036.24,4,4,4,12,Champions
9,35,4025.54,4,4,4,12,Champions
92,3,815.88,2,3,3,8,Potential Loyalist
59,1,430.44,2,1,2,5,At Risk
7,7,921.07,4,4,3,11,Champions
9,4,418.59000000000003,4,3,2,9,Loyal Customers
272,1,96.8,1,1,1,3,Lost
6,2,466.56,4,2,3,9,Loyal Customers
14,2,273.9,4,2,2,8,Potential Loyalist
77,1,479.13,2,1,3,6,At Risk
294,2,215.82,1,2,2,5,At Risk
143,4,1657.22,2,3,4,9,Loyal Customers
9,8,5940.0,4,4,4,12,Champions
86,2,199.20000000000002,2,2,1,5,At Risk
21,11,8982.7,3,4,4,11,Champions
148,3,615.37,1,3,3,7,Potential Loyalist
347,1,168.74,1,1,1,3,Lost
38,1,135.57,3,1,1,5,At Risk
7,4,393.79,4,3,2,9,Loyal Customers
3,14,2134.38,4,4,4,12,Champions
6,5,990.68,4,4,3,11,Champions
171,1,47.55,1,1,1,3,Lost
37,2,743.21,3,2,3,8,Potential Loyalist
27,3,253.5,3,3,2,8,Potential Loyalist
42,1,56.690000000000005,3,1,1,5,At Risk
303,1,178.22,1,1,1,3,Lost
16,2,334.79,4,2,2,8,Potential Loyalist
295,2,347.40000000000003,1,2,2,5,At Risk
3,1,56.15,4,1,1,6,At Risk
9,3,504.34,4,3,3,10,Loyal Customers
41,3,430.85,3,3,2,8,Potential Loyalist
231,2,276.28,1,2,2,5,At Risk
7,8,2981.15,4,4,4,12,Champions
4,8,3828.03,4,4,4,12,Champions
230,1,149.46,1,1,1,3,Lost
15,7,647.79,4,4,3,11,Champions
64,4,398.21999999999997,2,3,2,7,Potential Loyalist
9,3,210.64,4,3,2,9,Loyal Customers
32,8,1232.8,3,4,4,11,Champions
32,4,623.07,3,3,3,9,Loyal Customers
210,2,109.07000000000001,1,2,1,4,Lost
191,3,333.06,1,3,2,6,At Risk
62,2,185.0,2,2,1,5,At Risk
15,20,3527.02,4,4,4,12,Champions
3,1,350.26,4,1,2,7,Potential Loyalist
143,5,632.31,2,4,3,9,Loyal Customers
57,1,50.400000000000006,2,1,1,4,Lost
11,2,122.2,4,2,1,7,Potential Loyalist
6,1,251.16,4,1,2,7,Potential Loyalist
91,2,78.9,2,2,1,5,At Risk
11,2,629.12,4,2,3,9,Loyal Customers
69,2,128.48,2,2,1,5,At Risk
6,24,2557.28,4,4,4,12,Champions
298,2,355.26,1,2,2,5,At Risk
211,1,38.4,1,1,1,3,Lost
140,2,108.75,2,2,1,5,At Risk
14,2,547.36,4,2,3,9,Loyal Customers
106,3,378.78000000000003,2,3,2,7,Potential Loyalist
118,5,1565.24,2,4,4,10,Loyal Customers
22,8,604.3100000000001,3,4,3,10,Loyal Customers
28,1,255.87,3,1,2,6,At Risk
17,8,1172.14,4,4,4,12,Champions
64,2,641.6600000000001,2,2,3,7,Potential Loyalist
325,2,1176.67,1,2,4,7,Potential Loyalist
176,2,111.55000000000001,1,2,1,4,Lost
8,5,900.27,4,4,3,11,Champions
4,3,630.7,4,3,3,10,Loyal Customers
15,6,992.34,4,4,3,11,Champions
176,1,28.0,1,1,1,3,Lost
71,1,138.44,2,1,1,4,Lost
21,6,4601.58,3,4,4,11,Champions
34,2,349.76,3,2,2,7,Potential Loyalist
3,12,3475.62,4,4,4,12,Champions
42,3,485.08,3,3,3,9,Loyal Customers
8,6,1609.85,4,4,4,12,Champions
38,2,425.29,3,2,2,7,Potential Loyalist
52,1,655.97,2,1,3,6,At Risk
83,4,3183.59,2,3,4,9,Loyal Customers
63,1,100.8,2,1,1,4,Lost
30,24,5418.39,3,4,4,11,Champions
120,3,401.72,2,3,2,7,Potential Loyalist
24,2,242.36,3,2,2,7,Potential Loyalist
305,1,357.4,1,1,2,4,Lost
10,2,349.36,4,2,2,8,Potential Loyalist
80,1,283.26,2,1,2,5,At Risk
1,6,1719.1,4,4,4,12,Champions
218,1,122.39999999999999,1,1,1,3,Lost
245,1,283.05,1,1,2,4,Lost
239,2,22.62,1,2,1,4,Lost
28,6,2100.79,3,4,4,11,Champions
143,2,1789.94,2,2,4,8,Potential Loyalist
168,2,120.9,1,2,1,4,Lost
32,2,541.53,3,2,3,8,Potential Loyalist
37,6,1768.02,3,4,4,11,Champions
2,9,2545.34,4,4,4,12,Champions
7,6,1368.32,4,4,4,12,Champions
9,2,457.46999999999997,4,2,3,9,Loyal Customers
184,4,451.88,1,3,2,6,At Risk
195,1,111.8,1,1,1,3,Lost
357,1,219.62,1,1,2,4,Lost
118,4,216.49,2,3,2,7,Potential Loyalist
7,1,300.40000000000003,4,1,2,7,Potential Loyalist
35,2,551.99,3,2,3,8,Potential Loyalist
86,5,534.08,2,4,3,9,Loyal Customers
14,3,633.65,4,3,3,10,Loyal Customers
52,2,612.44,2,2,3,7,Potential Loyalist
8,5,1661.8600000000001,4,4,4,12,Champions
150,1,248.20000000000002,1,1,2,4,Lost
2,2,531.88,4,2,3,9,Loyal Customers
2,2,137.0,4,2,1,7,Potential Loyalist
8,5,1695.97,4,4,4,12,Champions
36,5,734.41,3,4,3,10,Loyal Customers
183,3,668.89,1,3,3,7,Potential Loyalist
71,1,194.37,2,1,1,4,Lost
69,1,511.82,2,1,3,6,At Risk
7,3,936.5600000000001,4,3,3,10,Loyal Customers
57,3,381.64,2,3,2,7,Potential Loyalist
253,1,376.97,1,1,2,4,Lost
50,2,361.52,2,2,2,6,At Risk
55,4,775.98,2,3,3,8,Potential Loyalist
6,9,1877.73,4,4,4,12,Champions
240,1,288.62,1,1,2,4,Lost
30,1,277.29,3,1,2,6,At Risk
350,1,251.10000000000002,1,1,2,4,Lost
67,1,235.74,2,1,2,5,At Risk
281,1,460.1,1,1,3,5,At Risk
212,2,259.35,1,2,2,5,At Risk
1,4,633.36,4,3,3,10,Loyal Customers
30,1,270.53000000000003,3,1,2,6,At Risk
198,9,1794.82,1,4,4,9,Loyal Customers
153,2,1006.94,1,2,3,6,At Risk
67,1,302.2,2,1,2,5,At Risk
253,2,574.73,1,2,3,6,At Risk
272,1,387.31,1,1,2,4,Lost
49,8,6115.14,3,4,4,11,Champions
16,1,282.98,4,1,2,7,Potential Loyalist
8,26,11329.92,4,4,4,12,Champions
43,8,1702.6100000000001,3,4,4,11,Champions
64,1,140.39999999999998,2,1,1,4,Lost
120,1,200.15,2,1,1,4,Lost
23,4,403.17,3,3,2,8,Potential Loyalist
7,5,654.91,4,4,3,11,Champions
300,1,128.44,1,1,1,3,Lost
9,6,1151.1000000000001,4,4,4,12,Champions
45,1,441.29,3,1,2,6,At Risk
21,3,684.59,3,3,3,9,Loyal Customers
130,4,584.9,2,3,3,8,Potential Loyalist
3,2,263.43,4,2,2,8,Potential Loyalist
353,1,145.0,1,1,1,3,Lost
351,1,295.5,1,1,2,4,Lost
352,2,107.2,1,2,1,4,Lost
45,4,712.4200000000001,3,3,3,9,Loyal Customers
9,7,2572.8,4,4,4,12,Champions
8,9,1898.56,4,4,4,12,Champions
181,1,233.1,1,1,2,4,Lost
45,1,223.36,3,1,2,6,At Risk
272,1,164.4,1,1,1,3,Lost
21,2,777.16,3,2,3,8,Potential Loyalist
17,1,92.66,4,1,1,6,At Risk
16,2,544.9,4,2,3,9,Loyal Customers
261,1,141.55,1,1,1,3,Lost
35,3,413.58,3,3,2,8,Potential Loyalist
225,1,103.3,1,1,1,3,Lost
15,2,16.439999999999998,4,2,1,7,Potential Loyalist
189,3,198.41,1,3,1,5,At Risk
351,1,298.34,1,1,2,4,Lost
52,4,859.27,2,3,3,8,Potential Loyalist
8,4,982.61,4,3,3,10,Loyal Customers
11,2,474.76,4,2,3,9,Loyal Customers
197,1,67.95,1,1,1,3,Lost
6,3,525.01,4,3,3,10,Loyal Customers
147,4,294.67,1,3,2,6,At Risk
11,1,140.0,4,1,1,6,At Risk
6,7,1078.82,4,4,3,11,Champions
16,3,409.36,4,3,2,9,Loyal Customers
17,1,349.81,4,1,2,7,Potential Loyalist
49,7,2589.57,3,4,4,11,Champions
324,1,242.6,1,1,2,4,Lost
42,3,1082.7,3,3,3,9,Loyal Customers
62,4,206.85000000000002,2,3,2,7,Potential Loyalist
21,3,336.44,3,3,2,8,Potential Loyalist
234,1,155.8,1,1,1,3,Lost
30,18,2479.35,3,4,4,11,Champions
209,1,96.3,1,1,1,3,Lost
129,2,258.11,2,2,2,6,At Risk
304,2,160.07,1,2,1,4,Lost
25,21,7174.13,3,4,4,11,Champions
228,1,99.37,1,1,1,3,Lost
119,1,424.15000000000003,2,1,2,5,At Risk
101,4,833.16,2,3,3,8,Potential Loyalist
92,2,428.5,2,2,2,6,At Risk
52,4,2086.87,2,3,4,9,Loyal Customers
9,2,967.71,4,2,3,9,Loyal Customers
65,7,1563.77,2,4,4,10,Loyal Customers
83,4,2477.26,2,3,4,9,Loyal Customers
77,2,993.18,2,2,3,7,Potential Loyalist
4,2,304.94,4,2,2,8,Potential Loyalist
15,7,1257.83,4,4,4,12,Champions
205,1,1093.74,1,1,3,5,At Risk
9,1,115.68,4,1,1,6,At Risk
230,1,108.45,1,1,1,3,Lost
15,5,3322.84,4,4,4,12,Champions
70,1,144.72,2,1,1,4,Lost
209,2,266.02,1,2,2,5,At Risk
25,2,193.42,3,2,1,6,At Risk
32,5,966.13,3,4,3,10,Loyal Customers
22,13,3079.37,3,4,4,11,Champions
45,6,1541.59,3,4,4,11,Champions
14,14,3937.02,4,4,4,12,Champions
49,1,350.47,3,1,2,6,At Risk
122,3,195.05,2,3,1,6,At Risk
240,2,554.83,1,2,3,6,At Risk
304,1,202.62,1,1,1,3,Lost
51,1,47.44,2,1,1,4,Lost
13,3,692.9,4,3,3,10,Loyal Customers
24,1,455.45,3,1,3,7,Potential Loyalist
6,2,747.43,4,2,3,9,Loyal Customers
10,4,1911.75,4,3,4,11,Champions
73,1,75.75,2,1,1,4,Lost
10,7,1267.07,4,4,4,12,Champions
161,2,219.39999999999998,1,2,2,5,At Risk
129,2,340.3,2,2,2,6,At Risk
23,4,1243.34,3,3,4,10,Loyal Customers
28,9,1592.27,3,4,4,11,Champions
11,1,285.56,4,1,2,7,Potential Loyalist
23,2,464.51,3,2,3,8,Potential Loyalist
268,1,60.2,1,1,1,3,Lost
78,1,114.3,2,1,1,4,Lost
111,2,635.49,2,2,3,7,Potential Loyalist
365,1,58.8,1,1,1,3,Lost
28,10,2037.45,3,4,4,11,Champions
211,3,810.7900000000001,1,3,3,7,Potential Loyalist
57,1,82.11,2,1,1,4,Lost
52,3,1224.6000000000001,2,3,4,9,Loyal Customers
130,1,781.49,2,1,3,6,At Risk
13,1,166.08,4,1,1,6,At Risk
3,10,3623.63,4,4,4,12,Champions
17,12,4274.92,4,4,4,12,Champions
30,3,531.22,3,3,3,9,Loyal Customers
269,1,80.65,1,1,1,3,Lost
2,7,1342.44,4,4,4,12,Champions
65,5,1177.25,2,4,4,10,Loyal Customers
17,2,200.22,4,2,1,7,Potential Loyalist
9,12,2354.81,4,4,4,12,Champions
133,1,186.05,2,1,1,4,Lost
17,7,1542.3600000000001,4,4,4,12,Champions
10,2,547.94,4,2,3,9,Loyal Customers
57,1,65.34,2,1,1,4,Lost
58,5,1708.07,2,4,4,10,Loyal Customers
30,1,70.25,3,1,1,5,At Risk
34,7,880.52,3,4,3,10,Loyal Customers
219,1,173.9,1,1,1,3,Lost
7,4,1119.59,4,3,4,11,Champions
42,2,2010.42,3,2,4,9,Loyal Customers
58,5,1308.93,2,4,4,10,Loyal Customers
66,2,271.32,2,2,2,6,At Risk
10,29,13384.17,4,4,4,12,Champions
50,5,1010.2,2,4,3,9,Loyal Customers
27,20,3212.33,3,4,4,11,Champions
255,1,298.11,1,1,2,4,Lost
44,2,892.86,3,2,3,8,Potential Loyalist
15,1,151.4,4,1,1,6,At Risk
2,6,2353.4900000000002,4,4,4,12,Champions
35,1,201.01,3,1,1,5,At Risk
8,7,2535.26,4,4,4,12,Champions
72,6,3487.01,2,4,4,10,Loyal Customers
22,15,3287.92,3,4,4,11,Champions
350,2,242.70000000000002,1,2,2,5,At Risk
119,4,611.04,2,3,3,8,Potential Loyalist
129,1,166.47,2,1,1,4,Lost
133,1,251.92000000000002,2,1,2,5,At Risk
123,2,607.94,2,2,3,7,Potential Loyalist
30,8,1751.63,3,4,4,11,Champions
228,1,298.25,1,1,2,4,Lost
252,1,154.95,1,1,1,3,Lost
8,4,2135.39,4,3,4,11,Champions
244,1,193.65,1,1,1,3,Lost
22,4,1016.99,3,3,3,9,Loyal Customers
27,3,798.74,3,3,3,9,Loyal Customers
160,2,729.99,1,2,3,6,At Risk
22,8,1412.72,3,4,4,11,Champions
36,16,6204.09,3,4,4,11,Champions
177,2,50.400000000000006,1,2,1,4,Lost
179,2,258.58,1,2,2,5,At Risk
161,1,58.25,1,1,1,3,Lost
2,2,369.8,4,2,2,8,Potential Loyalist
36,1,403.21,3,1,2,6,At Risk
312,1,153.0,1,1,1,3,Lost
21,10,4455.29,3,4,4,11,Champions
224,1,113.85,1,1,1,3,Lost
29,15,3669.72,3,4,4,11,Champions
18,4,860.54,3,3,3,9,Loyal Customers
88,4,1560.26,2,3,4,9,Loyal Customers
164,2,163.9,1,2,1,4,Lost
63,3,820.2,2,3,3,8,Potential Loyalist
8,11,2946.2799999999997,4,4,4,12,Champions
7,1,923.35,4,1,3,8,Potential Loyalist
57,2,2026.0,2,2,4,8,Potential Loyalist
20,12,3572.98,3,4,4,11,Champions
71,4,871.06,2,3,3,8,Potential Loyalist
364,1,222.52,1,1,2,4,Lost
30,2,471.63,3,2,3,8,Potential Loyalist
45,3,567.91,3,3,3,9,Loyal Customers
29,18,11412.16,3,4,4,11,Champions
1,2,215.59,4,2,2,8,Potential Loyalist
1,2,137.64000000000001,4,2,1,7,Potential Loyalist
11,4,1351.81,4,3,4,11,Champions
3,7,2131.35,4,4,4,12,Champions
105,2,200.86,2,2,1,5,At Risk
17,5,1046.26,4,4,3,11,Champions
232,1,74.8,1,1,1,3,Lost
104,1,71.4,2,1,1,4,Lost
170,2,478.95,1,2,3,6,At Risk
28,8,1103.62,3,4,3,10,Loyal Customers
29,4,947.01,3,3,3,9,Loyal Customers
6,28,4036.85,4,4,4,12,Champions
11,8,3130.05,4,4,4,12,Champions
9,3,680.49,4,3,3,10,Loyal Customers
13,2,218.25,4,2,2,8,Potential Loyalist
24,1,285.64,3,1,2,6,At Risk
255,1,15.0,1,1,1,3,Lost
42,2,725.62,3,2,3,8,Potential Loyalist
150,3,263.83,1,3,2,6,At Risk
7,1,262.95,4,1,2,7,Potential Loyalist
25,2,958.44,3,2,3,8,Potential Loyalist
4,10,3311.63,4,4,4,12,Champions
190,3,286.57,1,3,2,6,At Risk
48,2,213.71,3,2,2,7,Potential Loyalist
2,2,134.32,4,2,1,7,Potential Loyalist
88,4,997.42,2,3,3,8,Potential Loyalist
246,1,56.4,1,1,1,3,Lost
16,3,647.41,4,3,3,10,Loyal Customers
13,3,494.86,4,3,3,10,Loyal Customers
151,1,62.17,1,1,1,3,Lost
64,2,274.97,2,2,2,6,At Risk
45,1,123.44,3,1,1,5,At Risk
77,2,238.67,2,2,2,6,At Risk
144,4,1677.94,2,3,4,9,Loyal Customers
121,1,8.2,2,1,1,4,Lost
273,1,191.65,1,1,1,3,Lost
18,14,1653.5,3,4,4,11,Champions
21,1,106.1,3,1,1,5,At Risk
17,1,172.32,4,1,1,6,At Risk
171,2,311.48,1,2,2,5,At Risk
32,4,585.95,3,3,3,9,Loyal Customers
14,3,644.63,4,3,3,10,Loyal Customers
14,10,2538.96,4,4,4,12,Champions
29,9,964.16,3,4,3,10,Loyal Customers
74,3,1145.07,2,3,4,9,Loyal Customers
65,1,211.83,2,1,2,5,At Risk
3,1,445.11,4,1,2,7,Potential Loyalist
8,4,729.45,4,3,3,10,Loyal Customers
3,37,5452.81,4,4,4,12,Champions
4,4,579.61,4,3,3,10,Loyal Customers
6,5,1221.03,4,4,4,12,Champions
28,4,36.56,3,3,1,7,Potential Loyalist
269,1,51.25,1,1,1,3,Lost
63,6,676.81,2,4,3,9,Loyal Customers
43,1,235.84,3,1,2,6,At Risk
234,4,1388.64,1,3,4,8,Potential Loyalist
14,4,902.02,4,3,3,10,Loyal Customers
290,1,765.34,1,1,3,5,At Risk
253,2,165.65,1,2,1,4,Lost
25,1,35.400000000000006,3,1,1,5,At Risk
41,1,148.53,3,1,1,5,At Risk
1,2,189.7,4,2,1,7,Potential Loyalist
39,1,110.21000000000001,3,1,1,5,At Risk
34,8,1101.23,3,4,3,10,Loyal Customers
18,5,1870.56,3,4,4,11,Champions
34,1,338.8,3,1,2,6,At Risk
1,119,30571.57,4,4,4,12,Champions
295,1,178.63,1,1,1,3,Lost
98,1,51.559999999999995,2,1,1,4,Lost
140,6,331.02,2,4,2,8,Potential Loyalist
255,3,64.60000000000001,1,3,1,5,At Risk
364,34,4462.16,1,4,4,9,Loyal Customers
3,2,114.34,4,2,1,7,Potential Loyalist
177,2,120.01,1,2,1,4,Lost
364,1,199.02,1,1,1,3,Lost
225,2,131.0,1,2,1,4,Lost
350,1,5.5,1,1,1,3,Lost
45,8,1672.24,3,4,4,11,Champions
296,1,124.81,1,1,1,3,Lost
360,1,221.0,1,1,2,4,Lost
16,7,1255.32,4,4,4,12,Champions
315,1,260.0,1,1,2,4,Lost
51,6,2891.44,2,4,4,10,Loyal Customers
4,3,523.28,4,3,3,10,Loyal Customers
22,18,6390.820000000001,3,4,4,11,Champions
134,1,170.8,2,1,1,4,Lost
22,3,240.77,3,3,2,8,Potential Loyalist
99,5,275.03,2,4,2,8,Potential Loyalist
6,10,1076.57,4,4,3,11,Champions
196,1,131.42000000000002,1,1,1,3,Lost
72,5,1083.46,2,4,3,9,Loyal Customers
177,6,527.07,1,4,3,8,Potential Loyalist
162,1,158.01,1,1,1,3,Lost
35,1,244.83,3,1,2,6,At Risk
165,1,154.67,1,1,1,3,Lost
356,1,387.82,1,1,2,4,Lost
296,1,133.35000000000002,1,1,1,3,Lost
6,3,340.85,4,3,2,9,Loyal Customers
303,3,454.59,1,3,3,7,Potential Loyalist
4,1,173.44,4,1,1,6,At Risk
23,3,498.56,3,3,3,9,Loyal Customers
121,1,47.05,2,1,1,4,Lost
51,6,402.47,2,4,2,8,Potential Loyalist
204,2,162.42,1,2,1,4,Lost
314,2,523.77,1,2,3,6,At Risk
153,1,203.85999999999999,1,1,1,3,Lost
49,2,121.1,3,2,1,6,At Risk
217,1,71.35000000000001,1,1,1,3,Lost
63,8,905.76,2,4,3,9,Loyal Customers
36,1,82.91,3,1,1,5,At Risk
164,3,405.35,1,3,2,6,At Risk
77,2,138.14,2,2,1,5,At Risk
151,1,95.59,1,1,1,3,Lost
182,2,97.19999999999999,1,2,1,4,Lost
21,1,41.78,3,1,1,5,At Risk
13,1,102.22,4,1,1,6,At Risk
148,3,339.84000000000003,1,3,2,6,At Risk
239,1,55.95,1,1,1,3,Lost
365,1,229.45,1,1,2,4,Lost
1,1,294.35,4,1,2,7,Potential Loyalist
302,5,195.13,1,4,1,6,At Risk
50,2,342.34,2,2,2,6,At Risk
37,3,324.33,3,3,2,8,Potential Loyalist
80,1,615.48,2,1,3,6,At Risk
3,15,3048.85,4,4,4,12,Champions
55,4,775.67,2,3,3,8,Potential Loyalist
3,4,703.38,4,3,3,10,Loyal Customers
125,2,309.23,2,2,2,6,At Risk
37,2,155.56,3,2,1,6,At Risk
300,1,196.20000000000002,1,1,1,3,Lost
27,5,707.4,3,4,3,10,Loyal Customers
125,2,255.0,2,2,2,6,At Risk
20,3,1188.92,3,3,4,10,Loyal Customers
50,1,307.68,2,1,2,5,At Risk
130,2,137.29,2,2,1,5,At Risk
23,3,105.0,3,3,1,7,Potential Loyalist
151,1,99.14,1,1,1,3,Lost
225,2,79.78,1,2,1,4,Lost
29,1,136.68,3,1,1,5,At Risk
142,2,47.58,2,2,1,5,At Risk
64,3,365.15,2,3,2,7,Potential Loyalist
31,3,208.38000000000002,3,3,2,8,Potential Loyalist
60,10,1743.2,2,4,4,10,Loyal Customers
211,2,55.599999999999994,1,2,1,4,Lost
58,1,96.25,2,1,1,4,Lost
108,1,136.16,2,1,1,4,Lost
163,1,73.78,1,1,1,3,Lost
13,37,858.24,4,4,3,11,Champions
134,1,82.44,2,1,1,4,Lost
23,2,334.74,3,2,2,7,Potential Loyalist
29,14,2084.05,3,4,4,11,Champions
143,2,155.43,2,2,1,5,At Risk
363,1,95.22,1,1,1,3,Lost
365,1,269.4,1,1,2,4,Lost
158,2,63.45,1,2,1,4,Lost
202,1,299.13,1,1,2,4,Lost
233,1,97.39,1,1,1,3,Lost
43,1,299.48,3,1,2,6,At Risk
16,3,687.9,4,3,3,10,Loyal Customers
7,13,3828.05,4,4,4,12,Champions
364,1,314.04,1,1,2,4,Lost
21,1,95.29,3,1,1,5,At Risk
357,1,129.5,1,1,1,3,Lost
27,4,601.73,3,3,3,9,Loyal Customers
157,3,228.15,1,3,2,6,At Risk
137,1,131.68,2,1,1,4,Lost
14,1,574.95,4,1,3,8,Potential Loyalist
48,1,20.8,3,1,1,5,At Risk
177,1,123.92999999999999,1,1,1,3,Lost
3,7,99.92,4,4,1,9,Loyal Customers
228,3,585.84,1,3,3,7,Potential Loyalist
217,2,67.85,1,2,1,4,Lost
113,4,549.43,2,3,3,8,Potential Loyalist
273,1,23.6,1,1,1,3,Lost
66,8,1272.31,2,4,4,10,Loyal Customers
29,2,336.46,3,2,2,7,Potential Loyalist
4,2,275.03000000000003,4,2,2,8,Potential Loyalist
354,1,115.97,1,1,1,3,Lost
39,1,89.02,3,1,1,5,At Risk
15,1,251.53000000000003,4,1,2,7,Potential Loyalist
62,4,71.53,2,3,1,6,At Risk
227,1,182.29,1,1,1,3,Lost
248,1,61.6,1,1,1,3,Lost
365,1,92.84,1,1,1,3,Lost
147,2,129.81,1,2,1,4,Lost
20,1,150.52,3,1,1,5,At Risk
24,5,955.5,3,4,3,10,Loyal Customers
100,2,53.589999999999996,2,2,1,5,At Risk
43,1,28.5,3,1,1,5,At Risk
27,1,597.64,3,1,3,7,Potential Loyalist
144,1,67.63,2,1,1,4,Lost
90,1,115.31,2,1,1,4,Lost
34,1,12.7,3,1,1,5,At Risk
326,1,73.5,1,1,1,3,Lost
57,1,75.97,2,1,1,4,Lost
13,2,347.04,4,2,2,8,Potential Loyalist
27,3,257.44,3,3,2,8,Potential Loyalist
24,3,405.62,3,3,2,8,Potential Loyalist
146,6,33.17,1,4,1,6,At Risk
11,2,340.20000000000005,4,2,2,8,Potential Loyalist
3,21,2982.09,4,4,4,12,Champions
45,1,93.35,3,1,1,5,At Risk
16,3,456.81,4,3,3,10,Loyal Customers
28,9,1177.8,3,4,4,11,Champions
37,1,156.15,3,1,1,5,At Risk
195,2,95.97,1,2,1,4,Lost
351,1,74.4,1,1,1,3,Lost
62,1,283.02,2,1,2,5,At Risk
31,9,4734.1900000000005,3,4,4,11,Champions
280,1,293.7,1,1,2,4,Lost
1,1,6.959999999999999,4,1,1,6,At Risk
15,3,290.56,4,3,2,9,Loyal Customers
13,10,1053.39,4,4,3,11,Champions
165,3,282.45,1,3,2,6,At Risk
125,1,48.0,2,1,1,4,Lost
78,11,1557.47,2,4,4,10,Loyal Customers
67,1,318.0,2,1,2,5,At Risk
32,1,319.03,3,1,2,6,At Risk
18,5,1879.85,3,4,4,11,Champions
249,2,369.4,1,2,2,5,At Risk
177,1,247.44,1,1,2,4,Lost
106,11,725.3000000000001,2,4,3,9,Loyal Customers
365,1,185.3,1,1,1,3,Lost
15,10,2141.4900000000002,4,4,4,12,Champions
25,10,2198.21,3,4,4,11,Champions
209,2,185.98,1,2,1,4,Lost
37,3,610.51,3,3,3,9,Loyal Customers
28,3,290.58000000000004,3,3,2,8,Potential Loyalist
17,1,585.41,4,1,3,8,Potential Loyalist
322,2,689.95,1,2,3,6,At Risk
266,1,101.34,1,1,1,3,Lost
53,1,133.67000000000002,2,1,1,4,Lost
30,8,2476.12,3,4,4,11,Champions
112,2,398.59999999999997,2,2,2,6,At Risk
73,6,1705.46,2,4,4,10,Loyal Customers
304,2,283.8,1,2,2,5,At Risk
3,3,766.73,4,3,3,10,Loyal Customers
118,5,1435.42,2,4,4,10,Loyal Customers
119,1,160.35999999999999,2,1,1,4,Lost
3,2,163.95,4,2,1,7,Potential Loyalist
27,12,4801.26,3,4,4,11,Champions
29,1,424.64,3,1,2,6,At Risk
29,1,103.53,3,1,1,5,At Risk
321,1,196.9,1,1,1,3,Lost
246,1,201.2,1,1,1,3,Lost
6,23,2946.07,4,4,4,12,Champions
11,1,218.4,4,1,2,7,Potential Loyalist
4,2,198.52,4,2,1,7,Potential Loyalist
282,1,137.9,1,1,1,3,Lost
59,8,1099.07,2,4,3,9,Loyal Customers
17,1,225.74,4,1,2,7,Potential Loyalist
2,26,4672.75,4,4,4,12,Champions
359,1,140.51,1,1,1,3,Lost
206,1,75.35,1,1,1,3,Lost
141,2,635.6,2,2,3,7,Potential Loyalist
14,5,1230.83,4,4,4,12,Champions
16,2,389.16,4,2,2,8,Potential Loyalist
21,4,1035.31,3,3,3,9,Loyal Customers
52,1,198.57999999999998,2,1,1,4,Lost
11,3,258.74,4,3,2,9,Loyal Customers
235,1,99.80000000000001,1,1,1,3,Lost
7,3,941.16,4,3,3,10,Loyal Customers
20,4,206.25,3,3,2,8,Potential Loyalist
55,3,767.33,2,3,3,8,Potential Loyalist
287,1,67.80000000000001,1,1,1,3,Lost
9,6,3112.86,4,4,4,12,Champions
207,1,134.4,1,1,1,3,Lost
108,2,895.8100000000001,2,2,3,7,Potential Loyalist
22,11,912.1500000000001,3,4,3,10,Loyal Customers
4,4,2761.12,4,3,4,11,Champions
132,2,160.35000000000002,2,2,1,5,At Risk
37,2,147.83999999999997,3,2,1,6,At Risk
42,3,323.7,3,3,2,8,Potential Loyalist
24,3,566.58,3,3,3,9,Loyal Customers
126,2,560.7,2,2,3,7,Potential Loyalist
35,1,207.73999999999998,3,1,2,6,At Risk
67,3,351.46,2,3,2,7,Potential Loyalist
4,2,698.49,4,2,3,9,Loyal Customers
1,2,453.4,4,2,2,8,Potential Loyalist
293,1,257.25,1,1,2,4,Lost
49,2,499.06,3,2,3,8,Potential Loyalist
7,5,1281.32,4,4,4,12,Champions
29,1,337.40000000000003,3,1,2,6,At Risk
169,1,177.66,1,1,1,3,Lost
15,3,1259.46,4,3,4,11,Champions
167,6,863.68,1,4,3,8,Potential Loyalist
52,1,151.65,2,1,1,4,Lost
25,3,490.51,3,3,3,9,Loyal Customers
50,5,675.6800000000001,2,4,3,9,Loyal Customers
22,15,4039.5,3,4,4,11,Champions
78,4,884.98,2,3,3,8,Potential Loyalist
350,1,419.05,1,1,2,4,Lost
23,6,1279.02,3,4,4,11,Champions
120,4,1521.22,2,3,4,9,Loyal Customers
1,5,1233.24,4,4,4,12,Champions
51,5,1357.25,2,4,4,10,Loyal Customers
16,1,340.35,4,1,2,7,Potential Loyalist
219,2,512.87,1,2,3,6,At Risk
241,1,214.25,1,1,2,4,Lost
7,3,1344.72,4,3,4,11,Champions
69,2,891.34,2,2,3,7,Potential Loyalist
184,2,219.16000000000003,1,2,2,5,At Risk
253,1,37.4,1,1,1,3,Lost
63,1,698.82,2,1,3,6,At Risk
157,1,208.91,1,1,2,4,Lost
87,2,588.43,2,2,3,7,Potential Loyalist
23,15,1747.39,3,4,4,11,Champions
97,1,163.8,2,1,1,4,Lost
191,3,1058.99,1,3,3,7,Potential Loyalist
149,1,126.07,1,1,1,3,Lost
63,3,1673.55,2,3,4,9,Loyal Customers
28,2,408.86,3,2,2,7,Potential Loyalist
20,1,139.10000000000002,3,1,1,5,At Risk
1,5,1796.78,4,4,4,12,Champions
17,5,515.0699999999999,4,4,3,11,Champions
318,1,207.82,1,1,2,4,Lost
228,1,232.48000000000002,1,1,2,4,Lost
81,1,266.34000000000003,2,1,2,5,At Risk
23,1,360.85,3,1,2,6,At Risk
21,2,515.67,3,2,3,8,Potential Loyalist
203,2,299.0,1,2,2,5,At Risk
34,9,1432.55,3,4,4,11,Champions
14,5,913.82,4,4,3,11,Champions
84,1,333.87,2,1,2,5,At Risk
31,13,4902.6,3,4,4,11,Champions
255,1,158.95000000000002,1,1,1,3,Lost
13,11,3918.23,4,4,4,12,Champions
36,11,4400.21,3,4,4,11,Champions
209,1,30.0,1,1,1,3,Lost
48,2,760.0,3,2,3,8,Potential Loyalist
3,20,3664.7,4,4,4,12,Champions
1,7,2032.9,4,4,4,12,Champions
184,5,1492.02,1,4,4,9,Loyal Customers
73,4,533.57,2,3,3,8,Potential Loyalist
63,3,1477.78,2,3,4,9,Loyal Customers
21,6,818.64,3,4,3,10,Loyal Customers
57,4,693.8199999999999,2,3,3,8,Potential Loyalist
210,5,1457.81,1,4,4,9,Loyal Customers
38,1,125.58000000000001,3,1,1,5,At Risk
1,17,1786.64,4,4,4,12,Champions
64,4,1629.92,2,3,4,9,Loyal Customers
141,6,1481.08,2,4,4,10,Loyal Customers
225,1,29.5,1,1,1,3,Lost
114,2,599.84,2,2,3,7,Potential Loyalist
9,1,81.66,4,1,1,6,At Risk
302,1,270.62,1,1,2,4,Lost
42,2,385.67,3,2,2,7,Potential Loyalist
81,1,103.3,2,1,1,4,Lost
31,8,2012.26,3,4,4,11,Champions
16,3,2203.6000000000004,4,3,4,11,Champions
164,6,2127.31,1,4,4,9,Loyal Customers
35,2,314.29,3,2,2,7,Potential Loyalist
132,1,149.48,2,1,1,4,Lost
17,3,1042.4,4,3,3,10,Loyal Customers
64,2,609.11,2,2,3,7,Potential Loyalist
358,1,168.6,1,1,1,3,Lost
30,2,244.9,3,2,2,7,Potential Loyalist
37,5,2427.08,3,4,4,11,Champions
249,1,51.0,1,1,1,3,Lost
22,1,163.17,3,1,1,5,At Risk
35,1,213.46,3,1,2,6,At Risk
50,1,110.38,2,1,1,4,Lost
65,1,173.9,2,1,1,4,Lost
269,1,137.0,1,1,1,3,Lost
172,1,46.92,1,1,1,3,Lost
118,1,60.790000000000006,2,1,1,4,Lost
1,15,1843.98,4,4,4,12,Champions
34,3,960.76,3,3,3,9,Loyal Customers
